Senator,Party,Organization,Total,PACs,Individuals
"Baldwin, Tammy",(D),University of Wisconsin,528258,0,528258
"Baldwin, Tammy",(D),JStreetPAC,216748,9706,207042
"Baldwin, Tammy",(D),Democracy Engine,187684,0,187684
"Baldwin, Tammy",(D),League of Conservation Voters,97896,12213,85683
"Baldwin, Tammy",(D),State of Wisconsin,91576,0,91576
"Baldwin, Tammy",(D),Womencount PAC,89659,25,89634
"Baldwin, Tammy",(D),Emily's List,85291,5000,80291
"Baldwin, Tammy",(D),"Paul, Weiss et al",67589,0,67589
"Baldwin, Tammy",(D),Marshfield Clinic,63387,0,63387
"Baldwin, Tammy",(D),Northwestern Mutual,58117,37400,20717
"Baldwin, Tammy",(D),Medical College of Wisconsin,52002,0,52002
"Baldwin, Tammy",(D),"Michael, Best & Friedrich",50073,6500,43573
"Baldwin, Tammy",(D),Epic Systems,47577,0,47577
"Baldwin, Tammy",(D),University of California,44415,0,44415
"Baldwin, Tammy",(D),Foley & Lardner,43128,7500,35628
"Baldwin, Tammy",(D),National Education Assn,42155,25000,17155
"Baldwin, Tammy",(D),Francisco Partners,41800,0,41800
"Baldwin, Tammy",(D),AT&T Inc,41383,3000,38383
"Baldwin, Tammy",(D),Operating Engineers Union,41280,41000,280
"Baldwin, Tammy",(D),American Federation of Teachers,40130,40000,130
"Baldwin, Tammy",(D),Congaree River LP,39950,0,39950
"Baldwin, Tammy",(D),Oshkosh Corp,39520,10000,29520
"Baldwin, Tammy",(D),Lockheed Martin,38541,36000,2541
"Baldwin, Tammy",(D),Farm Credit Council,37500,37500,0
"Baldwin, Tammy",(D),American Assn for Justice,35920,35000,920
"Baldwin, Tammy",(D),International Brotherhood of Electrical Workers,35710,35000,710
"Baldwin, Tammy",(D),Molson Coors Beverage Co,35610,29000,6610
"Baldwin, Tammy",(D),Bricklayers Union,35000,35000,0
"Baldwin, Tammy",(D),"Habush, Habush & Rottier",34841,0,34841
"Baldwin, Tammy",(D),Alphabet Inc,34440,14000,20440
"Baldwin, Tammy",(D),IBM Corp,33490,0,33490
"Baldwin, Tammy",(D),Mayo Clinic,33412,0,33412
"Baldwin, Tammy",(D),National Assn of Letter Carriers,32850,32500,350
"Baldwin, Tammy",(D),Arenberg Holdings,32700,0,32700
"Baldwin, Tammy",(D),Comcast Corp,32092,25000,7092
"Baldwin, Tammy",(D),WEC Energy Group,31333,20500,10833
"Baldwin, Tammy",(D),Uw Health,31311,0,31311
"Baldwin, Tammy",(D),Forest County Potawatomi Community,30500,0,30500
"Baldwin, Tammy",(D),National Air Traffic Controllers Assn,30500,30500,0
"Baldwin, Tammy",(D),American Federation of State/Cnty/Munic Employees,30377,25000,5377
"Baldwin, Tammy",(D),Communications Workers of America,30292,30000,292
"Baldwin, Tammy",(D),Carpenters & Joiners Union,30150,30000,150
"Baldwin, Tammy",(D),American Hospital Assn,29700,8000,21700
"Baldwin, Tammy",(D),Laborers Union,29010,29000,10
"Baldwin, Tammy",(D),Northrop Grumman,28800,27500,1300
"Baldwin, Tammy",(D),Ho-Chunk Nation,28513,0,28513
"Baldwin, Tammy",(D),Microsoft Corp,28325,8500,19825
"Baldwin, Tammy",(D),Air Line Pilots Assn,27525,27500,25
"Baldwin, Tammy",(D),Painters & Allied Trades Union,27500,27500,0
"Baldwin, Tammy",(D),National Beer Wholesalers Assn,27000,25000,2000
"Baldwin, Tammy",(D),City University of New York,26251,0,26251
"Baldwin, Tammy",(D),Charter Communications,26185,26000,185
"Baldwin, Tammy",(D),Honeywell International,26097,25000,1097
"Baldwin, Tammy",(D),NCTA The Internet & Television Assn,26015,20000,6015
"Baldwin, Tammy",(D),Bend The Arc Jewish Action,25900,9500,16400
"Baldwin, Tammy",(D),PricewaterhouseCoopers,25891,16000,9891
"Baldwin, Tammy",(D),US Venture Inc,25000,14900,10100
"Baldwin, Tammy",(D),Kaiser Permanente,24881,0,24881
"Baldwin, Tammy",(D),Gundersen Health System,24836,0,24836
"Baldwin, Tammy",(D),Planned Parenthood,24658,7999,16659
"Baldwin, Tammy",(D),Quarles & Brady,24655,0,24655
"Baldwin, Tammy",(D),Renaissance Technologies,24300,0,24300
"Baldwin, Tammy",(D),Invariant LLC,24200,0,24200
"Baldwin, Tammy",(D),General Motors,24010,23500,510
"Baldwin, Tammy",(D),Analysis Group,23100,0,23100
"Baldwin, Tammy",(D),Stanford University,22813,0,22813
"Baldwin, Tammy",(D),America's Credit Unions,22225,20000,2225
"Baldwin, Tammy",(D),"Fried, Frank et al",22217,0,22217
"Baldwin, Tammy",(D),University of Texas,21955,0,21955
"Baldwin, Tammy",(D),Goldman Sachs,21702,0,21702
"Baldwin, Tammy",(D),General Dynamics,21682,20500,1182
"Baldwin, Tammy",(D),Bluestem Asset Management,21600,0,21600
"Baldwin, Tammy",(D),Exact Sciences Corp,21353,0,21353
"Baldwin, Tammy",(D),"Sheet Metal, Air, Rail & Transportation Union",21025,21000,25
"Baldwin, Tammy",(D),Sierra Nevada Corp,20950,10000,10950
"Baldwin, Tammy",(D),Morgan Stanley,20730,0,20730
"Baldwin, Tammy",(D),"Town of Somerset, MD",20700,0,20700
"Baldwin, Tammy",(D),Thrivent Financial,20640,19500,1140
"Baldwin, Tammy",(D),General Electric,20557,11000,9557
"Baldwin, Tammy",(D),National Assn of Broadcasters,20500,19500,1000
"Baldwin, Tammy",(D),Brico Fund/Time Out Enterprises,20400,0,20400
"Baldwin, Tammy",(D),Teamsters Union,20100,20000,100
"Baldwin, Tammy",(D),Madison Metro School District,20099,0,20099
"Baldwin, Tammy",(D),US Dept of Veterans Affairs,19687,0,19687
"Baldwin, Tammy",(D),Cox Enterprises,19650,7500,12150
"Baldwin, Tammy",(D),Human Rights Campaign,19574,14339,5235
"Baldwin, Tammy",(D),American Property Casualty Insurance Assn,19500,19500,0
"Baldwin, Tammy",(D),Wisconsin Fertility Insitute,19400,0,19400
"Baldwin, Tammy",(D),Amazon.com,19381,13500,5881
"Baldwin, Tammy",(D),AFLAC Inc,19379,11500,7879
"Baldwin, Tammy",(D),University of Pennsylvania,19287,0,19287
"Baldwin, Tammy",(D),Advocate Aurora Health,19121,0,19121
"Baldwin, Tammy",(D),National Assn of Realtors,19060,19000,60
"Baldwin, Tammy",(D),Walmart Inc,19045,12000,7045
"Baldwin, Tammy",(D),Multiplan Inc,19000,0,19000
"Baldwin, Tammy",(D),"Quinn, Emanuel et al",18959,0,18959
"Baldwin, Tammy",(D),American Medical Assn,18920,5000,13920
"Baldwin, Tammy",(D),"Williams, Hart et al",18900,0,18900
"Baldwin, Tammy",(D),Telephone & Data Systems Inc,18820,12500,6320
"Baldwin, Tammy",(D),Hewlett Packard Enterprise,18730,18000,730
"Barrasso, John A",(R),Pinnacle West Capital,77800,35000,42800
"Barrasso, John A",(R),Amgen Inc,77150,40000,37150
"Barrasso, John A",(R),Delta Air Lines,70610,25000,45610
"Barrasso, John A",(R),CVS Health,57425,42500,14925
"Barrasso, John A",(R),Sinclair Companies,54850,0,54850
"Barrasso, John A",(R),NextEra Energy,54550,28000,26550
"Barrasso, John A",(R),Berkshire Hathaway,54038,38000,16038
"Barrasso, John A",(R),Exelon Corp,50400,30000,20400
"Barrasso, John A",(R),Blue Cross/Blue Shield,49025,43500,5525
"Barrasso, John A",(R),Abbott Laboratories,48000,48000,0
"Barrasso, John A",(R),AbbVie Inc,44550,29500,15050
"Barrasso, John A",(R),Verizon Communications,43500,37000,6500
"Barrasso, John A",(R),Blackstone Group,43200,0,43200
"Barrasso, John A",(R),Neurological Surgery PC,43200,0,43200
"Barrasso, John A",(R),Marathon Petroleum,43000,43000,0
"Barrasso, John A",(R),United Parcel Service,43000,43000,0
"Barrasso, John A",(R),Clearpath Foundation,42700,0,42700
"Barrasso, John A",(R),American Dental Assn,42500,42500,0
"Barrasso, John A",(R),Merck & Co,42500,40000,2500
"Barrasso, John A",(R),American Medical Assn,40250,40000,250
"Barrasso, John A",(R),Northrop Grumman,40050,40000,50
"Barrasso, John A",(R),Automotive Free International Trade PAC,40000,40000,0
"Barrasso, John A",(R),Comcast Corp,40000,40000,0
"Barrasso, John A",(R),National Assn of Home Builders,40000,40000,0
"Barrasso, John A",(R),National Assn of Real Estate Investment Trusts,40000,40000,0
"Barrasso, John A",(R),National Multifamily Housing Council,40000,40000,0
"Barrasso, John A",(R),National Assn of Convenience Stores,39500,39500,0
"Barrasso, John A",(R),Pfizer Inc,38700,30000,8700
"Barrasso, John A",(R),National Assn of Broadcasters,38500,37500,1000
"Barrasso, John A",(R),Union Pacific Corp,38500,38500,0
"Barrasso, John A",(R),FirstEnergy Corp,38250,37000,1250
"Barrasso, John A",(R),National Beer Wholesalers Assn,37500,37500,0
"Barrasso, John A",(R),iHeartMedia Inc,36400,31000,5400
"Barrasso, John A",(R),Eastman Chemical,36000,36000,0
"Barrasso, John A",(R),Chevron Corp,35900,14000,21900
"Barrasso, John A",(R),Honeywell International,35010,35000,10
"Barrasso, John A",(R),American Hotel & Lodging Assn,35000,35000,0
"Barrasso, John A",(R),Charter Communications,35000,35000,0
"Barrasso, John A",(R),Hewlett Packard Enterprise,35000,35000,0
"Barrasso, John A",(R),Mortgage Bankers Assn,35000,35000,0
"Barrasso, John A",(R),NCTA The Internet & Television Assn,35000,35000,0
"Barrasso, John A",(R),Norfolk Southern,35000,35000,0
"Barrasso, John A",(R),UnitedHealth Group,35000,35000,0
"Barrasso, John A",(R),Wine & Spirits Wholesalers of America,35000,35000,0
"Barrasso, John A",(R),Walmart Inc,34900,29500,5400
"Barrasso, John A",(R),Microsoft Corp,34000,34000,0
"Barrasso, John A",(R),National Rural Electric Cooperative Assn,34000,34000,0
"Barrasso, John A",(R),FMC Corp,33300,22000,11300
"Barrasso, John A",(R),Home Depot,32501,32000,501
"Barrasso, John A",(R),CSX Corp,32500,32500,0
"Barrasso, John A",(R),Google Inc,32500,32500,0
"Barrasso, John A",(R),Sempra Energy,32500,32500,0
"Barrasso, John A",(R),Fierce Government Relations,32400,0,32400
"Barrasso, John A",(R),Occidental Petroleum,32300,21000,11300
"Barrasso, John A",(R),FedEx Corp,32000,32000,0
"Barrasso, John A",(R),PG&E Corp,32000,27000,5000
"Barrasso, John A",(R),Capital Group Companies,31900,12000,19900
"Barrasso, John A",(R),1st Financial Bank USA,31000,0,31000
"Barrasso, John A",(R),Eli Lilly & Co,30200,27500,2700
"Barrasso, John A",(R),Fluor Corp,30000,30000,0
"Barrasso, John A",(R),General Dynamics,30000,30000,0
"Barrasso, John A",(R),Humana Inc,30000,30000,0
"Barrasso, John A",(R),Valero Energy,30000,30000,0
"Barrasso, John A",(R),National Assn of Realtors,29000,29000,0
"Barrasso, John A",(R),Williams Companies,29000,17000,12000
"Barrasso, John A",(R),Apollo Global Management,28800,5000,23800
"Barrasso, John A",(R),Ford Motor Co,28535,27500,1035
"Barrasso, John A",(R),Massachusetts Mutual Life Insurance,28500,28000,500
"Barrasso, John A",(R),Medquest Pharmacy,28000,0,28000
"Barrasso, John A",(R),"Brownstein, Hyatt et al",27900,14500,13400
"Barrasso, John A",(R),General Motors,27700,25000,2700
"Barrasso, John A",(R),Peabody Energy,27550,27500,50
"Barrasso, John A",(R),Centene Corp,27500,11500,16000
"Barrasso, John A",(R),National Apartment Assn,27500,27500,0
"Barrasso, John A",(R),National Auto Dealers Assn,27500,27500,0
"Barrasso, John A",(R),Williams & Jensen,27450,2000,25450
"Barrasso, John A",(R),Southern Co,27015,27000,15
"Barrasso, John A",(R),Sanofi US,27000,24500,2500
"Barrasso, John A",(R),American Assn of Orthopaedic Surgeons,26500,26500,0
"Barrasso, John A",(R),"National Stone, Sand & Gravel Assn",26000,26000,0
"Barrasso, John A",(R),Parsons Corp,26000,26000,0
"Barrasso, John A",(R),DISH Network,25700,5000,20700
"Barrasso, John A",(R),Koch Industries,25400,20000,5400
"Barrasso, John A",(R),Cherokee Nation,25000,0,25000
"Barrasso, John A",(R),Prudential Financial,25000,25000,0
"Barrasso, John A",(R),American Trucking Assns,24500,22500,2000
"Barrasso, John A",(R),BGR Group,24500,0,24500
"Barrasso, John A",(R),S-3 Group,24000,0,24000
"Barrasso, John A",(R),Energy Capital Partners,23900,13500,10400
"Barrasso, John A",(R),Ingram Industries,23100,10000,13100
"Barrasso, John A",(R),HollyFrontier Corp,22500,22500,0
"Barrasso, John A",(R),International Paper,22500,22500,0
"Barrasso, John A",(R),McKesson Corp,22500,22500,0
"Barrasso, John A",(R),Harbinger Strategies,22250,0,22250
"Barrasso, John A",(R),EmergeOrtho,22196,10000,12196
"Barrasso, John A",(R),Crestview Partners,21600,0,21600
"Barrasso, John A",(R),Pharmaceutical Research & Manufacturers Of America,21500,11500,10000
"Barrasso, John A",(R),Dannenbaum Engineering,21400,0,21400
"Barrasso, John A",(R),American Academy of Dermatology Assn,21000,21000,0
"Barrasso, John A",(R),Ernst & Young,21000,20000,1000
"Bennet, Michael",(D),League of Conservation Voters,297105,12499,284606
"Bennet, Michael",(D),Blackstone Group,149900,0,149900
"Bennet, Michael",(D),Votesane PAC,122000,0,122000
"Bennet, Michael",(D),University of Colorado,120956,0,120956
"Bennet, Michael",(D),"Akin, Gump et al",104250,10578,93672
"Bennet, Michael",(D),Oaktree Capital Management,89700,0,89700
"Bennet, Michael",(D),Goldman Sachs,88800,23000,65800
"Bennet, Michael",(D),Pershing Square Capital Management,86100,0,86100
"Bennet, Michael",(D),Comcast Corp,83055,30000,53055
"Bennet, Michael",(D),"Brownstein, Hyatt et al",77625,7500,70125
"Bennet, Michael",(D),Amgen Inc,74000,24000,50000
"Bennet, Michael",(D),Breckenridge Grand Vacations,70200,0,70200
"Bennet, Michael",(D),Alphabet Inc,69205,25000,44205
"Bennet, Michael",(D),JPMorgan Chase & Co,63095,24000,39095
"Bennet, Michael",(D),Fidelity Investments,61350,22500,38850
"Bennet, Michael",(D),Capital Group Companies,58200,15000,43200
"Bennet, Michael",(D),Hogan Lovells,54800,2000,52800
"Bennet, Michael",(D),AT&T Inc,51594,23500,28094
"Bennet, Michael",(D),Liberty Media Corp,49450,5000,44450
"Bennet, Michael",(D),WilmerHale LLP,48590,0,48590
"Bennet, Michael",(D),CVS Health,47508,24500,23008
"Bennet, Michael",(D),Democratic Senatorial Campaign Cmte,46800,46800,0
"Bennet, Michael",(D),Centerbridge Partners,46700,0,46700
"Bennet, Michael",(D),Gilead Sciences,46300,12500,33800
"Bennet, Michael",(D),Access Industries,46200,0,46200
"Bennet, Michael",(D),"Haddon, Morgan, Foreman Pc",45300,0,45300
"Bennet, Michael",(D),DISH Network,44823,22500,22323
"Bennet, Michael",(D),Xcel Energy,43395,20000,23395
"Bennet, Michael",(D),RTX Corp,41564,41000,564
"Bennet, Michael",(D),State of Colorado,41046,0,41046
"Bennet, Michael",(D),Arnold & Porter,39750,5000,34750
"Bennet, Michael",(D),Tiber Creek Group,39400,0,39400
"Bennet, Michael",(D),"Paul, Weiss et al",39085,0,39085
"Bennet, Michael",(D),DaVita Inc,38889,21500,17389
"Bennet, Michael",(D),"Angelo, Gordon & Co",38350,0,38350
"Bennet, Michael",(D),Loews Corp,37425,5000,32425
"Bennet, Michael",(D),CoBank,37138,0,37138
"Bennet, Michael",(D),Sares-Regis Group,35100,0,35100
"Bennet, Michael",(D),Select Medical Corp,35000,20000,15000
"Bennet, Michael",(D),Urology Center of Colorado,34425,0,34425
"Bennet, Michael",(D),National Assn for Home Care,34400,5000,29400
"Bennet, Michael",(D),Latham & Watkins,33100,0,33100
"Bennet, Michael",(D),National Assn of Real Estate Investment Trusts,33000,25000,8000
"Bennet, Michael",(D),MWWPR,32600,5000,27600
"Bennet, Michael",(D),Pacific Alternative Asset Management,32400,0,32400
"Bennet, Michael",(D),Alston & Bird,32100,22500,9600
"Bennet, Michael",(D),Merck & Co,31508,31500,8
"Bennet, Michael",(D),Pfizer Inc,31020,27500,3520
"Bennet, Michael",(D),Microsoft Corp,31002,19000,12002
"Bennet, Michael",(D),Mortgage Bankers Assn,31000,30000,1000
"Bennet, Michael",(D),Molson Coors Brewing,30755,10000,20755
"Bennet, Michael",(D),KPMG LLP,30400,25000,5400
"Bennet, Michael",(D),CH2M HILL,30325,9000,21325
"Bennet, Michael",(D),Union Pacific Corp,30260,30000,260
"Bennet, Michael",(D),Lumen Technologies,30063,6000,24063
"Bennet, Michael",(D),TPG Capital,29700,0,29700
"Bennet, Michael",(D),Apollo Global Management,29600,7500,22100
"Bennet, Michael",(D),AbbVie Inc,29512,29000,512
"Bennet, Michael",(D),National Assn of Realtors,29500,29500,0
"Bennet, Michael",(D),Operating Engineers Union,29500,29500,0
"Bennet, Michael",(D),Blue Cross/Blue Shield,29410,22000,7410
"Bennet, Michael",(D),United Parcel Service,29395,29000,395
"Bennet, Michael",(D),"Gibson, Dunn & Crutcher",29200,5500,23700
"Bennet, Michael",(D),Democracy Engine,29100,0,29100
"Bennet, Michael",(D),BlackRock Inc,29000,7500,21500
"Bennet, Michael",(D),"Davis, Graham & Stubbs",28900,0,28900
"Bennet, Michael",(D),Purdue Pharma,28400,0,28400
"Bennet, Michael",(D),Albright Stonebridge Group,28272,0,28272
"Bennet, Michael",(D),"Welsh, Carson et al",28000,0,28000
"Bennet, Michael",(D),Peter G Peterson Foundation,27800,0,27800
"Bennet, Michael",(D),Ares Management,27600,0,27600
"Bennet, Michael",(D),National Multifamily Housing Council,27500,27500,0
"Bennet, Michael",(D),Deloitte LLP,27063,18500,8563
"Bennet, Michael",(D),Analysis Group,27000,0,27000
"Bennet, Michael",(D),Artery Capital Group,27000,0,27000
"Bennet, Michael",(D),"Munger, Tolles & Olson",26700,0,26700
"Bennet, Michael",(D),"Bryan, Cave et al",26631,-1000,27631
"Bennet, Michael",(D),Bank of America,26566,0,26566
"Bennet, Michael",(D),Greenlight Capital,26200,0,26200
"Bennet, Michael",(D),National Air Traffic Controllers Assn,26000,26000,0
"Bennet, Michael",(D),Cisco Systems,25668,9000,16668
"Bennet, Michael",(D),Hewlett Packard Enterprise,25520,25500,20
"Bennet, Michael",(D),Plumbers/Pipefitters Union,25450,25000,450
"Bennet, Michael",(D),Lockheed Martin,25403,19000,6403
"Bennet, Michael",(D),Facebook Inc,25300,9000,16300
"Bennet, Michael",(D),Wine & Spirits Wholesalers of America,25000,25000,0
"Bennet, Michael",(D),Vail Resorts,24970,15000,9970
"Bennet, Michael",(D),Harvard University,24817,0,24817
"Bennet, Michael",(D),Forest City Enterprises,24800,5000,19800
"Bennet, Michael",(D),Investment Co Institute,24500,23500,1000
"Bennet, Michael",(D),Bauman Foundation,24300,0,24300
"Bennet, Michael",(D),Colorado State University,24054,0,24054
"Bennet, Michael",(D),Federation of American Hospitals,24000,24000,0
"Bennet, Michael",(D),UnitedHealth Group,23945,18000,5945
"Bennet, Michael",(D),Farm Credit Council,23730,22730,1000
"Bennet, Michael",(D),University of Denver,23584,0,23584
"Bennet, Michael",(D),Morgan Stanley,23425,4000,19425
"Bennet, Michael",(D),JStreetPAC,23343,2500,20843
"Bennet, Michael",(D),"Kleiner, Perkins et al",23200,0,23200
"Bennet, Michael",(D),Steptoe & Johnson,23083,3500,19583
"Blackburn, Marsha",(R),Senate Conservatives Fund,289292,0,289292
"Blackburn, Marsha",(R),Club for Growth,220703,2603,218100
"Blackburn, Marsha",(R),CoreCivic Inc,57400,12500,44900
"Blackburn, Marsha",(R),HCA Inc,56100,10000,46100
"Blackburn, Marsha",(R),Southwestern Family of Companies,55300,0,55300
"Blackburn, Marsha",(R),FedEx Corp,52753,20000,32753
"Blackburn, Marsha",(R),AT&T Inc,47491,22000,25491
"Blackburn, Marsha",(R),National Republican Senatorial Cmte,47402,47400,2
"Blackburn, Marsha",(R),Copart Inc,46167,0,46167
"Blackburn, Marsha",(R),Franklin American Mortgage,43000,0,43000
"Blackburn, Marsha",(R),Comcast Corp,42950,20000,22950
"Blackburn, Marsha",(R),State of Tennessee,40620,0,40620
"Blackburn, Marsha",(R),Ingram Industries,40025,5700,34325
"Blackburn, Marsha",(R),DISH Network,37500,10500,27000
"Blackburn, Marsha",(R),Jackson National Life Insurance,37275,12500,24775
"Blackburn, Marsha",(R),Blackstone Group,35855,0,35855
"Blackburn, Marsha",(R),Koch Industries,35100,20000,15100
"Blackburn, Marsha",(R),Acadia Healthcare,33700,12500,21200
"Blackburn, Marsha",(R),Pilot Corp,32904,0,32904
"Blackburn, Marsha",(R),Gen Cap America,31800,0,31800
"Blackburn, Marsha",(R),Avkare,31600,0,31600
"Blackburn, Marsha",(R),McKee Foods,31075,0,31075
"Blackburn, Marsha",(R),Duke Energy,31050,10000,21050
"Blackburn, Marsha",(R),Advance Financial,30075,2500,27575
"Blackburn, Marsha",(R),Impala Asset Management,29400,0,29400
"Blackburn, Marsha",(R),Delta Air Lines,28450,15000,13450
"Blackburn, Marsha",(R),DaVita Inc,28250,16500,11750
"Blackburn, Marsha",(R),Tom James Co,27700,1000,26700
"Blackburn, Marsha",(R),Cooper Steel,27600,0,27600
"Blackburn, Marsha",(R),Lumen Technologies,27410,12500,14910
"Blackburn, Marsha",(R),Cash Express LLC,27400,0,27400
"Blackburn, Marsha",(R),Fitzgerald Glider Kits,27000,0,27000
"Blackburn, Marsha",(R),"Baker, Donelson et al",26371,2700,23671
"Blackburn, Marsha",(R),Quicken Loans,26200,10000,16200
"Blackburn, Marsha",(R),T-Mobile USA,25525,25000,525
"Blackburn, Marsha",(R),Altria Group,25016,20000,5016
"Blackburn, Marsha",(R),Marathon Petroleum,25010,25000,10
"Blackburn, Marsha",(R),Deloitte LLP,24935,12500,12435
"Blackburn, Marsha",(R),Jones Management Services,24800,0,24800
"Blackburn, Marsha",(R),Community Health Systems,24400,15000,9400
"Blackburn, Marsha",(R),Healthmark Ventures,24300,0,24300
"Blackburn, Marsha",(R),Powell Companies,24100,0,24100
"Blackburn, Marsha",(R),Lipman Brothers,23800,0,23800
"Blackburn, Marsha",(R),Charter Communications,23500,22500,1000
"Blackburn, Marsha",(R),Jonathan's Grille,22550,0,22550
"Blackburn, Marsha",(R),NorPAC,22300,0,22300
"Blackburn, Marsha",(R),Amgen Inc,22000,18000,4000
"Blackburn, Marsha",(R),Curb Records,22000,0,22000
"Blackburn, Marsha",(R),M&M Industries,22000,0,22000
"Blackburn, Marsha",(R),IDEMIA,21856,9956,11900
"Blackburn, Marsha",(R),NCTA The Internet & Television Assn,21600,15000,6600
"Blackburn, Marsha",(R),International Paper,21425,15000,6425
"Blackburn, Marsha",(R),PricewaterhouseCoopers,21250,20000,1250
"Blackburn, Marsha",(R),Fitzgerald Truck Parts & Sales,21200,0,21200
"Blackburn, Marsha",(R),National HealthCare Corp,20975,12500,8475
"Blackburn, Marsha",(R),Republican Jewish Coalition,20961,10000,10961
"Blackburn, Marsha",(R),BGR Group,20800,0,20800
"Blackburn, Marsha",(R),John Lee Co,20700,0,20700
"Blackburn, Marsha",(R),British American Tobacco,20500,20000,500
"Blackburn, Marsha",(R),United Parcel Service,20358,18500,1858
"Blackburn, Marsha",(R),Pfizer Inc,20250,17500,2750
"Blackburn, Marsha",(R),American College of Radiology,20000,20000,0
"Blackburn, Marsha",(R),National Assn of Broadcasters,19750,15000,4750
"Blackburn, Marsha",(R),Compassus,19700,0,19700
"Blackburn, Marsha",(R),Apollo Global Management,19533,12700,6833
"Blackburn, Marsha",(R),Committee to Defend the President,19529,12927,6602
"Blackburn, Marsha",(R),Berkshire Hathaway,19305,12000,7305
"Blackburn, Marsha",(R),Irby Investments,19300,0,19300
"Blackburn, Marsha",(R),Cumberland Pharmaceuticals,18900,7500,11400
"Blackburn, Marsha",(R),Jennmar Corp,18900,0,18900
"Blackburn, Marsha",(R),Winning for Women,18500,5000,13500
"Blackburn, Marsha",(R),Great America PAC,18345,7300,11045
"Blackburn, Marsha",(R),Recording Industry Assn of America,18000,7700,10300
"Blackburn, Marsha",(R),Community Oncology Alliance,17999,12999,5000
"Blackburn, Marsha",(R),Capstar Bank,17950,0,17950
"Blackburn, Marsha",(R),Beaman Automotive Group,17900,0,17900
"Blackburn, Marsha",(R),Walt Disney Co,17710,15000,2710
"Blackburn, Marsha",(R),Fortress Investment Group,17700,0,17700
"Blackburn, Marsha",(R),Cigna Corp,17525,17500,25
"Blackburn, Marsha",(R),Toyota Motor North America,17525,17500,25
"Blackburn, Marsha",(R),Federation of American Hospitals,17500,17500,0
"Blackburn, Marsha",(R),Massachusetts Mutual Life Insurance,17500,16500,1000
"Blackburn, Marsha",(R),National Multifamily Housing Council,17500,17500,0
"Blackburn, Marsha",(R),Eastman Chemical,17450,15000,2450
"Blackburn, Marsha",(R),Broadcast Music Inc,17400,15400,2000
"Blackburn, Marsha",(R),Continental Resources,17400,10000,7400
"Blackburn, Marsha",(R),Elliott Management,17200,0,17200
"Blackburn, Marsha",(R),Verizon Communications,17053,16000,1053
"Blackburn, Marsha",(R),Oracle Corp,17030,3280,13750
"Blackburn, Marsha",(R),Boyle Investment Co,16600,0,16600
"Blackburn, Marsha",(R),Fox Sports,16600,0,16600
"Blackburn, Marsha",(R),Yarbrough Capital LLC,16600,0,16600
"Blackburn, Marsha",(R),Telephone & Data Systems Inc,16450,11000,5450
"Blackburn, Marsha",(R),American Development Corp,16400,0,16400
"Blackburn, Marsha",(R),Design House,16400,0,16400
"Blackburn, Marsha",(R),First Regents Bancservices,16400,0,16400
"Blackburn, Marsha",(R),Giarratana Development,16400,0,16400
"Blackburn, Marsha",(R),Lexus of Memphis,16400,0,16400
"Blackburn, Marsha",(R),Treemont Capital,16400,0,16400
"Blackburn, Marsha",(R),Volunteer Lumber Sales,16400,0,16400
"Blumenthal, Richard",(D),Granite Telecommunications,100500,0,100500
"Blumenthal, Richard",(D),Charter Communications,76714,42000,34714
"Blumenthal, Richard",(D),RTX Corp,67678,44000,23678
"Blumenthal, Richard",(D),General Dynamics,63797,40000,23797
"Blumenthal, Richard",(D),"Early, Lucarelli et al",60142,0,60142
"Blumenthal, Richard",(D),Deloitte LLP,48808,40000,8808
"Blumenthal, Richard",(D),Altice USA,44855,16000,28855
"Blumenthal, Richard",(D),BlackRock Inc,44300,5000,39300
"Blumenthal, Richard",(D),UBS AG,42415,30000,12415
"Blumenthal, Richard",(D),Yale University,42264,0,42264
"Blumenthal, Richard",(D),Creative Artists Agency,41200,0,41200
"Blumenthal, Richard",(D),Microsoft Corp,40426,18500,21926
"Blumenthal, Richard",(D),Honeywell International,37750,36500,1250
"Blumenthal, Richard",(D),"Koskoff, Koskoff & Bieder",37702,0,37702
"Blumenthal, Richard",(D),Wirtz Corp,35500,0,35500
"Blumenthal, Richard",(D),International Brotherhood of Electrical Workers,35053,35000,53
"Blumenthal, Richard",(D),Crawford Group,33600,20000,13600
"Blumenthal, Richard",(D),Pfizer Inc,33473,30800,2673
"Blumenthal, Richard",(D),Harvard University,33396,0,33396
"Blumenthal, Richard",(D),American College of Emergency Physicians,32500,32500,0
"Blumenthal, Richard",(D),National Beer Wholesalers Assn,32500,32500,0
"Blumenthal, Richard",(D),Lockheed Martin,31339,31000,339
"Blumenthal, Richard",(D),American Assn for Justice,31000,30000,1000
"Blumenthal, Richard",(D),Mashantucket Pequot Tribal Nation,30783,0,30783
"Blumenthal, Richard",(D),Simmons Hanly Conroy,30600,0,30600
"Blumenthal, Richard",(D),National Air Traffic Controllers Assn,30500,30500,0
"Blumenthal, Richard",(D),Foster & Foster,30300,0,30300
"Blumenthal, Richard",(D),Enterprise Holdings,30200,27500,2700
"Blumenthal, Richard",(D),Intellectual Ventures LLC,29750,14000,15750
"Blumenthal, Richard",(D),Motley Rice LLC,29250,0,29250
"Blumenthal, Richard",(D),Atco Properties & Management,29088,0,29088
"Blumenthal, Richard",(D),National Assn of Broadcasters,29050,24000,5050
"Blumenthal, Richard",(D),Blue Harbour Group,28950,0,28950
"Blumenthal, Richard",(D),Belfer Management,28300,0,28300
"Blumenthal, Richard",(D),NorPAC,28210,0,28210
"Blumenthal, Richard",(D),Oracle Corp,27667,20000,7667
"Blumenthal, Richard",(D),Sabre GLBL,27500,27500,0
"Blumenthal, Richard",(D),Air Line Pilots Assn,27000,27000,0
"Blumenthal, Richard",(D),Apollo Global Management,26744,2000,24744
"Blumenthal, Richard",(D),Massachusetts Mutual Life Insurance,26473,22000,4473
"Blumenthal, Richard",(D),"Becton, Dickinson & Co",26250,12500,13750
"Blumenthal, Richard",(D),Marriott International,26205,11000,15205
"Blumenthal, Richard",(D),American Society of Travel Advisors,26000,26000,0
"Blumenthal, Richard",(D),Laborers Union,25500,25500,0
"Blumenthal, Richard",(D),Fresenius Medical Care,25403,10000,15403
"Blumenthal, Richard",(D),iHeartMedia Inc,23500,22000,1500
"Blumenthal, Richard",(D),Intercontinental Exchange Inc,23400,1000,22400
"Blumenthal, Richard",(D),Warburg Pincus,23300,0,23300
"Blumenthal, Richard",(D),Thornton Law Firm,22900,0,22900
"Blumenthal, Richard",(D),Lyndon Haviland & Co,22800,0,22800
"Blumenthal, Richard",(D),League of Conservation Voters,22746,4846,17900
"Blumenthal, Richard",(D),Wilmerhale Llp,22440,0,22440
"Blumenthal, Richard",(D),Cooney & Conway,22100,0,22100
"Blumenthal, Richard",(D),Greenberg Traurig LLP,21843,7410,14433
"Blumenthal, Richard",(D),DreamWorks SKG,21625,0,21625
"Blumenthal, Richard",(D),US Senate,21273,0,21273
"Blumenthal, Richard",(D),McGuireWoods LLP,21200,9500,11700
"Blumenthal, Richard",(D),"Newmark, Grubb et al",20958,0,20958
"Blumenthal, Richard",(D),"Kelley, Drye & Warren",20731,5681,15050
"Blumenthal, Richard",(D),Genentech Inc,20500,20500,0
"Blumenthal, Richard",(D),Malkin Holdings,20500,0,20500
"Blumenthal, Richard",(D),Elevation Partners,20400,0,20400
"Blumenthal, Richard",(D),Cigna Corp,20208,17000,3208
"Blumenthal, Richard",(D),Power Rogers LLP,20200,0,20200
"Blumenthal, Richard",(D),"Lieff, Cabraser et al",20097,0,20097
"Blumenthal, Richard",(D),National Assn of Realtors,20013,20000,13
"Blumenthal, Richard",(D),AFLAC Inc,20000,20000,0
"Blumenthal, Richard",(D),Laz Parking,19300,0,19300
"Blumenthal, Richard",(D),JPMorgan Chase & Co,19244,0,19244
"Blumenthal, Richard",(D),AT&T Inc,19018,2000,17018
"Blumenthal, Richard",(D),Asen & Co,18700,0,18700
"Blumenthal, Richard",(D),"Brownstein, Hyatt et al",18700,8000,10700
"Blumenthal, Richard",(D),Lone Pine Capital,18600,0,18600
"Blumenthal, Richard",(D),Bloomberg LP,18558,0,18558
"Blumenthal, Richard",(D),Debevoise & Plimpton,18513,0,18513
"Blumenthal, Richard",(D),Alexion Pharmaceuticals,18400,8500,9900
"Blumenthal, Richard",(D),Pitney Bowes Inc,18253,15000,3253
"Blumenthal, Richard",(D),Red Apple Group,18100,0,18100
"Blumenthal, Richard",(D),Henry Crown & Co,18000,0,18000
"Blumenthal, Richard",(D),Real Estate Roundtable,18000,18000,0
"Blumenthal, Richard",(D),Northrop Grumman,17991,16500,1491
"Blumenthal, Richard",(D),DLA Piper,17918,6500,11418
"Blumenthal, Richard",(D),Amd Homes,17900,0,17900
"Blumenthal, Richard",(D),Incept LLC,17900,0,17900
"Blumenthal, Richard",(D),Iranian American PAC,17800,17800,0
"Blumenthal, Richard",(D),Alternative Investment Group,17704,0,17704
"Blumenthal, Richard",(D),Centene Corp,17518,17500,18
"Blumenthal, Richard",(D),"Bernstein, Litowitz et al",17500,0,17500
"Blumenthal, Richard",(D),Clifford Law Offices,17500,0,17500
"Blumenthal, Richard",(D),National Assn of Letter Carriers,17000,17000,0
"Blumenthal, Richard",(D),Smiths Group,17000,14000,3000
"Blumenthal, Richard",(D),Winning Strategies Washington,16999,5500,11499
"Blumenthal, Richard",(D),Walt Disney Co,16836,7500,9336
"Blumenthal, Richard",(D),Blank Rome LLP,16700,4000,12700
"Blumenthal, Richard",(D),Hartford Financial Services,16585,10000,6585
"Blumenthal, Richard",(D),Merck & Co,16553,16500,53
"Blumenthal, Richard",(D),"Skadden, Arps et al",16218,0,16218
"Blumenthal, Richard",(D),Bad Robot Productions,16205,0,16205
"Blumenthal, Richard",(D),Hilliard Munoz Gonzales Llp,16200,0,16200
"Blumenthal, Richard",(D),Winstanley Enterprises,16200,0,16200
"Blunt, Roy",(R),Bayer AG,127493,59000,68493
"Blunt, Roy",(R),Edward Jones,108675,25300,83375
"Blunt, Roy",(R),Senior Star,87400,0,87400
"Blunt, Roy",(R),Crawford Group,82100,20000,62100
"Blunt, Roy",(R),Goldman Sachs,73950,18000,55950
"Blunt, Roy",(R),Woodbranch Investments,70000,0,70000
"Blunt, Roy",(R),Home Depot,66750,40000,26750
"Blunt, Roy",(R),National Assn of Broadcasters,66400,36000,30400
"Blunt, Roy",(R),Berkshire Hathaway,66250,39500,26750
"Blunt, Roy",(R),Comcast Corp,65200,40000,25200
"Blunt, Roy",(R),CSX Corp,60700,40000,20700
"Blunt, Roy",(R),Burns & McDonnell,59968,13000,46968
"Blunt, Roy",(R),AT&T Inc,59455,48000,11455
"Blunt, Roy",(R),UnitedHealth Group,56700,40000,16700
"Blunt, Roy",(R),Blackstone Group,56400,0,56400
"Blunt, Roy",(R),Emerson Electric,55600,11000,44600
"Blunt, Roy",(R),"Bryan, Cave et al",54040,7000,47040
"Blunt, Roy",(R),NorPAC,52900,10600,42300
"Blunt, Roy",(R),Ameren Corp,52550,37000,15550
"Blunt, Roy",(R),Centene Corp,51350,23500,27850
"Blunt, Roy",(R),Altria Group,51300,37500,13800
"Blunt, Roy",(R),CVS Health,51200,26000,25200
"Blunt, Roy",(R),Husch Blackwell LLP,50865,14500,36365
"Blunt, Roy",(R),Norfolk Southern,49800,35000,14800
"Blunt, Roy",(R),National Assn of Realtors,49082,40000,9082
"Blunt, Roy",(R),General Motors,49000,40000,9000
"Blunt, Roy",(R),National Republican Senatorial Cmte,46800,46800,0
"Blunt, Roy",(R),General Electric,46635,16500,30135
"Blunt, Roy",(R),Union Pacific Corp,45505,35000,10505
"Blunt, Roy",(R),Koch Industries,45300,20000,25300
"Blunt, Roy",(R),Charter Communications,45250,29000,16250
"Blunt, Roy",(R),Pan Am Equities,45000,0,45000
"Blunt, Roy",(R),Thompson Coburn LLP,44900,33500,11400
"Blunt, Roy",(R),Mallinckrodt Pharmaceuticals,44850,33500,11350
"Blunt, Roy",(R),Pfizer Inc,44700,39000,5700
"Blunt, Roy",(R),National Rural Electric Cooperative Assn,44400,39000,5400
"Blunt, Roy",(R),International Assn of Fire Fighters,43700,43500,200
"Blunt, Roy",(R),Blue Cross/Blue Shield,43525,43500,25
"Blunt, Roy",(R),Amgen Inc,43500,34500,9000
"Blunt, Roy",(R),Enterprise Holdings,43500,22500,21000
"Blunt, Roy",(R),Poet LLC,43300,10500,32800
"Blunt, Roy",(R),Herzog Contracting,43223,0,43223
"Blunt, Roy",(R),Diamond Pet Foods,43100,0,43100
"Blunt, Roy",(R),NCTA The Internet & Television Assn,43000,40000,3000
"Blunt, Roy",(R),Ford Motor Co,41425,31500,9925
"Blunt, Roy",(R),American Hospital Assn,40700,36000,4700
"Blunt, Roy",(R),Abbott Laboratories,40000,40000,0
"Blunt, Roy",(R),Alzheimer's Assn,40000,40000,0
"Blunt, Roy",(R),American Dental Assn,40000,40000,0
"Blunt, Roy",(R),National Assn of Home Builders,40000,40000,0
"Blunt, Roy",(R),National Beer Wholesalers Assn,40000,40000,0
"Blunt, Roy",(R),National Multifamily Housing Council,40000,40000,0
"Blunt, Roy",(R),T-Mobile USA,39500,39500,0
"Blunt, Roy",(R),United Parcel Service,39400,39000,400
"Blunt, Roy",(R),National Assn of Real Estate Investment Trusts,39000,39000,0
"Blunt, Roy",(R),US Travel Assn,39000,35500,3500
"Blunt, Roy",(R),Aristotle International,38300,0,38300
"Blunt, Roy",(R),America's Credit Unions,38000,38000,0
"Blunt, Roy",(R),Walmart Inc,38000,35000,3000
"Blunt, Roy",(R),Honeywell International,37725,35000,2725
"Blunt, Roy",(R),US Cellular,37700,35000,2700
"Blunt, Roy",(R),Deloitte LLP,37515,35000,2515
"Blunt, Roy",(R),National Assn of Convenience Stores,37500,37500,0
"Blunt, Roy",(R),Dot Foods,37300,0,37300
"Blunt, Roy",(R),American Institute of CPAs,37000,37000,0
"Blunt, Roy",(R),Merck & Co,37000,30000,7000
"Blunt, Roy",(R),FedEx Corp,36000,34000,2000
"Blunt, Roy",(R),Northrop Grumman,35725,33000,2725
"Blunt, Roy",(R),Visa Inc,35300,15000,20300
"Blunt, Roy",(R),Automotive Free International Trade PAC,35000,35000,0
"Blunt, Roy",(R),Outdoor Amusement Business Assn,35000,30000,5000
"Blunt, Roy",(R),Microsoft Corp,34400,22500,11900
"Blunt, Roy",(R),Atlas Air Worldwide,34300,22500,11800
"Blunt, Roy",(R),American Hotel & Lodging Assn,33500,33500,0
"Blunt, Roy",(R),Cgcn Group,33050,5500,27550
"Blunt, Roy",(R),American Trucking Assns,32900,30000,2900
"Blunt, Roy",(R),Cigna Corp,32776,22500,10276
"Blunt, Roy",(R),Boehringer Ingelheim Corp,32500,30000,2500
"Blunt, Roy",(R),Wine & Spirits Wholesalers of America,32500,32500,0
"Blunt, Roy",(R),Leon Medical Centers,32400,0,32400
"Blunt, Roy",(R),PricewaterhouseCoopers,31550,15000,16550
"Blunt, Roy",(R),Southwest Airlines,31500,22500,9000
"Blunt, Roy",(R),Anheuser-Busch,31250,20000,11250
"Blunt, Roy",(R),Fierce Government Relations,31000,0,31000
"Blunt, Roy",(R),Bristol-Myers Squibb,30500,24500,6000
"Blunt, Roy",(R),Southern Co,30500,28000,2500
"Blunt, Roy",(R),Koch Inc,30400,25000,5400
"Blunt, Roy",(R),American Academy of Dermatology Assn,30000,30000,0
"Blunt, Roy",(R),American Seniors Housing Assn,30000,30000,0
"Blunt, Roy",(R),Mortgage Bankers Assn,30000,30000,0
"Blunt, Roy",(R),Boeing Co,29707,25000,4707
"Blunt, Roy",(R),RTX Corp,29500,29500,0
"Blunt, Roy",(R),Amway/Alticor Inc,29000,2000,27000
"Blunt, Roy",(R),Veterans United Home Loans,28700,0,28700
"Blunt, Roy",(R),Exxon Mobil,28523,20000,8523
"Blunt, Roy",(R),H&R Block,28500,27000,1500
"Blunt, Roy",(R),KKR & Co,28500,10000,18500
"Blunt, Roy",(R),NAIOP Commercial Real Estate Devel Assn,28500,28500,0
"Blunt, Roy",(R),Charles Schwab Corp,28400,5000,23400
"Blunt, Roy",(R),Eli Lilly & Co,28400,21000,7400
"Booker, Cory",(D),Microsoft Corp,72044,10000,62044
"Booker, Cory",(D),Gibbons PC,69922,5000,64922
"Booker, Cory",(D),Wirtz Corp,66300,0,66300
"Booker, Cory",(D),Apollo Global Management,65657,2000,63657
"Booker, Cory",(D),Walt Disney Co,58648,0,58648
"Booker, Cory",(D),Lowenstein Sandler Llp,57928,0,57928
"Booker, Cory",(D),Harvest Partners,55785,0,55785
"Booker, Cory",(D),Sullivan & Cromwell,55780,0,55780
"Booker, Cory",(D),Alphabet Inc,52555,12000,40555
"Booker, Cory",(D),Allied Wallet,50800,0,50800
"Booker, Cory",(D),Comcast Corp,49609,12500,37109
"Booker, Cory",(D),"Carella, Byrne et al",48750,0,48750
"Booker, Cory",(D),Kirkland & Ellis,48660,0,48660
"Booker, Cory",(D),Blackstone Group,48031,0,48031
"Booker, Cory",(D),NorPAC,44600,0,44600
"Booker, Cory",(D),Wonderful Co,43965,0,43965
"Booker, Cory",(D),Bain Capital,43600,0,43600
"Booker, Cory",(D),United Airlines,43514,2000,41514
"Booker, Cory",(D),"Simpson, Thacher & Bartlett",42120,0,42120
"Booker, Cory",(D),HBJ Investments,40400,0,40400
"Booker, Cory",(D),Ironstate Holdings,39100,0,39100
"Booker, Cory",(D),William Blair & Co,38300,0,38300
"Booker, Cory",(D),Greenberg Traurig LLP,35755,2000,33755
"Booker, Cory",(D),Centerview Partners,34600,0,34600
"Booker, Cory",(D),Raj Assoc,34034,0,34034
"Booker, Cory",(D),Columbia University,33522,0,33522
"Booker, Cory",(D),GOLDMAN SACHS,33125,0,33125
"Booker, Cory",(D),Telebrands Corp,32900,0,32900
"Booker, Cory",(D),Amazon.com,32890,6000,26890
"Booker, Cory",(D),Creative Artists Agency,32883,0,32883
"Booker, Cory",(D),Columbia Property Trust,32800,0,32800
"Booker, Cory",(D),Latham & Watkins,32619,0,32619
"Booker, Cory",(D),AT&T Inc,32412,0,32412
"Booker, Cory",(D),"Kleiner, Perkins et al",31800,0,31800
"Booker, Cory",(D),"Paul, Weiss et al",31371,0,31371
"Booker, Cory",(D),Lauder Partners,31200,0,31200
"Booker, Cory",(D),Li & Fung,30300,0,30300
"Booker, Cory",(D),Gersh Agency,30134,0,30134
"Booker, Cory",(D),Eagle Capital Management,30000,0,30000
"Booker, Cory",(D),University of California,28937,0,28937
"Booker, Cory",(D),Stanford University,28796,0,28796
"Booker, Cory",(D),Menlo Realty Ventures,27900,0,27900
"Booker, Cory",(D),"Sills, Cummis & Gross",27800,0,27800
"Booker, Cory",(D),Bad Robot Productions,27678,0,27678
"Booker, Cory",(D),Silver Lake Partners,26299,0,26299
"Booker, Cory",(D),Blue Ridge Capital,26200,0,26200
"Booker, Cory",(D),Pretium Partners,25950,0,25950
"Booker, Cory",(D),Live Nation Entertainment,25444,0,25444
"Booker, Cory",(D),Phibro Animal Health,25310,0,25310
"Booker, Cory",(D),Conduent Inc,25309,5000,20309
"Booker, Cory",(D),Rxr Realty,25100,0,25100
"Booker, Cory",(D),American Assn for Justice,25050,25000,50
"Booker, Cory",(D),International Brotherhood of Electrical Workers,25040,25000,40
"Booker, Cory",(D),Landmark Hospitality,24875,0,24875
"Booker, Cory",(D),Marsh & McLennan,24604,2000,22604
"Booker, Cory",(D),Bill & Melinda Gates Foundation,24375,0,24375
"Booker, Cory",(D),Doherty Enterprises,24150,0,24150
"Booker, Cory",(D),Slate Path Capital,23900,0,23900
"Booker, Cory",(D),Inserra Supermarkets,23875,0,23875
"Booker, Cory",(D),Prudential Financial,23216,15000,8216
"Booker, Cory",(D),Scudiery Enterprises,23200,0,23200
"Booker, Cory",(D),CSX Corp,22555,22500,55
"Booker, Cory",(D),National Air Traffic Controllers Assn,22500,22500,0
"Booker, Cory",(D),Brown & Brown Insurance,22300,0,22300
"Booker, Cory",(D),New York Life Insurance,22166,20000,2166
"Booker, Cory",(D),Henry Crown & Co,21900,0,21900
"Booker, Cory",(D),Lyft Inc,21753,0,21753
"Booker, Cory",(D),Gps Investment Partners,21600,0,21600
"Booker, Cory",(D),Nimeks Organics,21600,0,21600
"Booker, Cory",(D),"Brownstein, Hyatt et al",21325,1000,20325
"Booker, Cory",(D),Berkshire Hathaway,21284,20000,1284
"Booker, Cory",(D),New York University,21254,0,21254
"Booker, Cory",(D),Diamond Castle Holdings,21200,0,21200
"Booker, Cory",(D),Harbourton Enterprises,21200,0,21200
"Booker, Cory",(D),"Pachulski, Stang et al",21200,0,21200
"Booker, Cory",(D),Operating Engineers Union,21026,15000,6026
"Booker, Cory",(D),Union Pacific Corp,20552,20000,552
"Booker, Cory",(D),Putnam Bridge,20500,0,20500
"Booker, Cory",(D),Lockton Companies,20225,0,20225
"Booker, Cory",(D),International Longshoremens Assn,20200,20200,0
"Booker, Cory",(D),Arenberg Holdings,20100,0,20100
"Booker, Cory",(D),Matrix Biology Institute,20100,0,20100
"Booker, Cory",(D),Service Employees International Union,20080,10000,10080
"Booker, Cory",(D),Teamsters Union,20010,20000,10
"Booker, Cory",(D),Lexus of Lehigh Valley,20000,0,20000
"Booker, Cory",(D),Norfolk Southern,20000,20000,0
"Booker, Cory",(D),Sesco Inc,19915,0,19915
"Booker, Cory",(D),UBS AG,19725,15000,4725
"Booker, Cory",(D),Eton Park Capital Management,19100,0,19100
"Booker, Cory",(D),Seeger Weiss LLP,18955,0,18955
"Booker, Cory",(D),Loews Corp,18930,0,18930
"Booker, Cory",(D),Verizon Communications,18912,6000,12912
"Booker, Cory",(D),Kraut Law Group,18400,0,18400
"Booker, Cory",(D),Lazard Ltd,18398,0,18398
"Booker, Cory",(D),Covenant House,18300,0,18300
"Booker, Cory",(D),Hugo Neu Corp,18300,0,18300
"Booker, Cory",(D),RIDA Development,17800,0,17800
"Booker, Cory",(D),Canoe Brook Management,17700,0,17700
"Booker, Cory",(D),Genki Advisory,17700,0,17700
"Booker, Cory",(D),Sagewind Capital,17700,0,17700
"Boozman, John",(R),Walmart Inc,86785,32000,54785
"Boozman, John",(R),Stephens Inc,64200,10000,54200
"Boozman, John",(R),AT&T Inc,42500,42500,0
"Boozman, John",(R),Lockheed Martin,42000,42000,0
"Boozman, John",(R),National Assn of Broadcasters,41468,33000,8468
"Boozman, John",(R),Tyson Foods,37950,29500,8450
"Boozman, John",(R),Berkshire Hathaway,36200,30000,6200
"Boozman, John",(R),CSX Corp,34500,34500,0
"Boozman, John",(R),National Multifamily Housing Council,32500,32500,0
"Boozman, John",(R),Northrop Grumman,32500,32500,0
"Boozman, John",(R),Wine & Spirits Wholesalers of America,32500,32500,0
"Boozman, John",(R),iHeartMedia Inc,31000,30000,1000
"Boozman, John",(R),Union Pacific Corp,30250,30000,250
"Boozman, John",(R),American Hotel & Lodging Assn,30000,30000,0
"Boozman, John",(R),Honeywell International,29550,29500,50
"Boozman, John",(R),National Cotton Council,29000,28500,500
"Boozman, John",(R),American Council of Engineering Cos,28500,28500,0
"Boozman, John",(R),Deloitte LLP,28500,28000,500
"Boozman, John",(R),American Bankers Assn,28000,28000,0
"Boozman, John",(R),NextEra Energy,27500,14000,13500
"Boozman, John",(R),Comcast Corp,25500,25500,0
"Boozman, John",(R),RTX Corp,25500,25500,0
"Boozman, John",(R),US Senate,25400,0,25400
"Boozman, John",(R),American Society of Interventional Pain Physicians,25000,25000,0
"Boozman, John",(R),General Dynamics,25000,25000,0
"Boozman, John",(R),International Paper,25000,25000,0
"Boozman, John",(R),Riceland Foods,24000,21500,2500
"Boozman, John",(R),United Parcel Service,23500,23500,0
"Boozman, John",(R),Alpine Group,23133,0,23133
"Boozman, John",(R),Capital Group Companies,22700,20000,2700
"Boozman, John",(R),1st Financial Bank USA,22666,0,22666
"Boozman, John",(R),Bayer AG,22500,22500,0
"Boozman, John",(R),National Assn of Real Estate Investment Trusts,22500,22500,0
"Boozman, John",(R),National Air Traffic Controllers Assn,22000,22000,0
"Boozman, John",(R),NorPAC,22000,0,22000
"Boozman, John",(R),Blessey Marine Service,21900,12500,9400
"Boozman, John",(R),Experian,21750,20500,1250
"Boozman, John",(R),Goldman Sachs,21700,15000,6700
"Boozman, John",(R),Clearpath Foundation,21200,0,21200
"Boozman, John",(R),Murphy Oil,20900,5000,15900
"Boozman, John",(R),National Assn of Realtors,20500,20500,0
"Boozman, John",(R),Common Values PAC,20000,20000,0
"Boozman, John",(R),Koch Industries,20000,20000,0
"Boozman, John",(R),PotlatchDeltic Corp,19800,9000,10800
"Boozman, John",(R),Independent Community Bankers of America,19000,19000,0
"Boozman, John",(R),MCNA Dental Plans,18900,0,18900
"Boozman, John",(R),International Council of Shopping Centers,18625,18625,0
"Boozman, John",(R),JPMorgan Chase & Co,18500,18500,0
"Boozman, John",(R),General Atomics,18000,18000,0
"Boozman, John",(R),American Dental Assn,17500,17500,0
"Boozman, John",(R),American Financial Services Assn,17500,17500,0
"Boozman, John",(R),American Optometric Assn,17500,17500,0
"Boozman, John",(R),National Beer Wholesalers Assn,17500,17500,0
"Boozman, John",(R),Campbell Soup,17000,17000,0
"Boozman, John",(R),Cerner Corp,17000,17000,0
"Boozman, John",(R),FedEx Corp,17000,16000,1000
"Boozman, John",(R),National Chicken Council,17000,17000,0
"Boozman, John",(R),DaVita Inc,16500,16500,0
"Boozman, John",(R),Anheuser-Busch,16250,16000,250
"Boozman, John",(R),Microsoft Corp,16000,16000,0
"Boozman, John",(R),State of Arkansas,15730,0,15730
"Boozman, John",(R),Aircraft Owners & Pilots Assn,15500,15500,0
"Boozman, John",(R),Cooper Communities,15500,0,15500
"Boozman, John",(R),Koch Inc,15500,15500,0
"Boozman, John",(R),Automotive Free International Trade PAC,15000,15000,0
"Boozman, John",(R),Defend America PAC,15000,15000,0
"Boozman, John",(R),Free State PAC,15000,15000,0
"Boozman, John",(R),Home Depot,15000,15000,0
"Boozman, John",(R),Lank PAC,15000,15000,0
"Boozman, John",(R),LiveRamp Inc,15000,15000,0
"Boozman, John",(R),National Confectioners Assn,15000,13000,2000
"Boozman, John",(R),National Thoroughbred Racing Assn,15000,15000,0
"Boozman, John",(R),Norfolk Southern,15000,15000,0
"Boozman, John",(R),USA Rice Federation,15000,15000,0
"Boozman, John",(R),Occidental Petroleum,14800,4000,10800
"Boozman, John",(R),Entergy Corp,14750,13500,1250
"Boozman, John",(R),NCTA The Internet & Television Assn,14500,14500,0
"Boozman, John",(R),Verizon Communications,14500,13500,1000
"Boozman, John",(R),AFLAC Inc,14000,14000,0
"Boozman, John",(R),California Dairies Inc,14000,14000,0
"Boozman, John",(R),Eastman Chemical,14000,14000,0
"Boozman, John",(R),Liberty Mutual Insurance,14000,14000,0
"Boozman, John",(R),National Turkey Federation,13500,13500,0
"Boozman, John",(R),Nucor Corp,13400,8000,5400
"Boozman, John",(R),First Service Bank,13300,0,13300
"Boozman, John",(R),Farm Credit Council,13000,13000,0
"Boozman, John",(R),New York Life Insurance,13000,12500,500
"Boozman, John",(R),Regions Financial,13000,13000,0
"Boozman, John",(R),Renaissance Technologies,12800,0,12800
"Boozman, John",(R),Arvest Bank Group,12750,11000,1750
"Boozman, John",(R),Air Line Pilots Assn,12500,12500,0
"Boozman, John",(R),General Motors,12500,12500,0
"Boozman, John",(R),Hewlett Packard Enterprise,12500,12500,0
"Boozman, John",(R),National Auto Dealers Assn,12500,12500,0
"Boozman, John",(R),National Cattlemen's Beef Assn,12500,12500,0
"Boozman, John",(R),PRINTING United Alliance,12250,12250,0
"Boozman, John",(R),Kmac,12200,0,12200
"Boozman, John",(R),Abbott Laboratories,12166,8000,4166
"Boozman, John",(R),Cboe Global Markets,12000,12000,0
"Boozman, John",(R),Marathon Petroleum,12000,12000,0
"Braun, Mike",(R),Senate Conservatives Fund,217112,0,217112
"Braun, Mike",(R),Club for Growth,82183,0,82183
"Braun, Mike",(R),National Republican Senatorial Cmte,47400,47400,0
"Braun, Mike",(R),Jasper Engines & Transmissions,47050,0,47050
"Braun, Mike",(R),Reyes Holdings,40800,0,40800
"Braun, Mike",(R),Alliance Resource Partners,40400,10000,30400
"Braun, Mike",(R),Wabash Valley Produce,32000,0,32000
"Braun, Mike",(R),Eli Lilly & Co,31088,10000,21088
"Braun, Mike",(R),Enterprise Holdings,28700,11000,17700
"Braun, Mike",(R),Streicher Construction,27100,0,27100
"Braun, Mike",(R),Berkshire Hathaway,26150,7500,18650
"Braun, Mike",(R),Barnes & Thornburg,24425,1000,23425
"Braun, Mike",(R),Jennmar Corp,24300,0,24300
"Braun, Mike",(R),Magnolia Health Systems,22100,0,22100
"Braun, Mike",(R),Ackerman Oil,21600,0,21600
"Braun, Mike",(R),Graber Post Buildings,21600,0,21600
"Braun, Mike",(R),Putco Inc,21600,0,21600
"Braun, Mike",(R),Specialty Equipment Market Assn,19750,12000,7750
"Braun, Mike",(R),Bowen Engineering,19000,0,19000
"Braun, Mike",(R),Marathon Petroleum,17500,17500,0
"Braun, Mike",(R),Newmar Corp,17400,0,17400
"Braun, Mike",(R),Charles Schwab Corp,16700,0,16700
"Braun, Mike",(R),Roche Holdings,16450,13500,2950
"Braun, Mike",(R),Amway/Alticor Inc,16200,0,16200
"Braun, Mike",(R),Maple Leaf Farms,16200,0,16200
"Braun, Mike",(R),AT&T Inc,16005,15000,1005
"Braun, Mike",(R),Republican Jewish Coalition,15850,5000,10850
"Braun, Mike",(R),Ice Miller LLP,15677,2500,13177
"Braun, Mike",(R),Wells Fargo,15450,2500,12950
"Braun, Mike",(R),UnitedHealth Group,15400,7500,7900
"Braun, Mike",(R),Comcast Corp,15000,15000,0
"Braun, Mike",(R),Goldman Sachs,15000,5000,10000
"Braun, Mike",(R),National Turkey Federation,15000,15000,0
"Braun, Mike",(R),"Bose, McKinney & Evans",14800,0,14800
"Braun, Mike",(R),Orthoindy Hospital,14400,0,14400
"Braun, Mike",(R),"Hall, Render et al",14311,14311,0
"Braun, Mike",(R),Meyer Distributing,14250,0,14250
"Braun, Mike",(R),Cardon & Assoc,13900,0,13900
"Braun, Mike",(R),Warehouse Services Inc,13700,0,13700
"Braun, Mike",(R),Automotive Color & Supply,13600,0,13600
"Braun, Mike",(R),Freedom Bank,13500,0,13500
"Braun, Mike",(R),Heritage Group,13500,0,13500
"Braun, Mike",(R),Pilot Corp,13500,0,13500
"Braun, Mike",(R),Kelley Automotive Group,13100,0,13100
"Braun, Mike",(R),Kirkland & Ellis,13100,0,13100
"Braun, Mike",(R),Deloitte LLP,12945,7500,5445
"Braun, Mike",(R),Permian Enterprises,12883,0,12883
"Braun, Mike",(R),Blackstone Group,12800,0,12800
"Braun, Mike",(R),American United Life Insurance,12750,5000,7750
"Braun, Mike",(R),American Bankers Assn,12525,12500,25
"Braun, Mike",(R),Council of Insurance Agents & Brokers,12500,12500,0
"Braun, Mike",(R),Memorial Hospital,12450,0,12450
"Braun, Mike",(R),Kindred Healthcare,12248,10000,2248
"Braun, Mike",(R),Smoker Craft,12100,0,12100
"Braun, Mike",(R),Solution Tree,12050,0,12050
"Braun, Mike",(R),International Franchise Assn,12000,12000,0
"Braun, Mike",(R),United Parcel Service,12000,10000,2000
"Braun, Mike",(R),American Consolidated Natural Resources,11850,0,11850
"Braun, Mike",(R),E&A Companies,11800,0,11800
"Braun, Mike",(R),Ofs Brands,11400,0,11400
"Braun, Mike",(R),Steel Dynamics Inc,11400,0,11400
"Braun, Mike",(R),German American Bancorp,11050,0,11050
"Braun, Mike",(R),Truist Financial,11025,10000,1025
"Braun, Mike",(R),American Suburban Utilities,10900,0,10900
"Braun, Mike",(R),Task Force Tips,10850,0,10850
"Braun, Mike",(R),AON Corp,10800,0,10800
"Braun, Mike",(R),Ball Ventures,10800,0,10800
"Braun, Mike",(R),Bernard Marcus Family Foundation,10800,0,10800
"Braun, Mike",(R),Bluff Point Assoc,10800,0,10800
"Braun, Mike",(R),Continental Investors,10800,0,10800
"Braun, Mike",(R),Drg Holdings LLC,10800,0,10800
"Braun, Mike",(R),Geo Pfau's Sons,10800,0,10800
"Braun, Mike",(R),Harbour Group Industries,10800,0,10800
"Braun, Mike",(R),HJ Kalikow & Co,10800,0,10800
"Braun, Mike",(R),HQ Investments,10800,0,10800
"Braun, Mike",(R),Hunter Engineering,10800,0,10800
"Braun, Mike",(R),Living Stones Foundation Ct,10800,0,10800
"Braun, Mike",(R),Longford Capital Management,10800,0,10800
"Braun, Mike",(R),Melaleuca Inc,10800,0,10800
"Braun, Mike",(R),Northwest Excavating,10800,0,10800
"Braun, Mike",(R),Route One Investment,10800,0,10800
"Braun, Mike",(R),Schnuck Markets,10800,0,10800
"Braun, Mike",(R),Sequoia Capital,10800,0,10800
"Braun, Mike",(R),Stripco Inc,10800,0,10800
"Braun, Mike",(R),UM Holdings,10800,0,10800
"Braun, Mike",(R),Wallace Electrical Systems,10800,0,10800
"Braun, Mike",(R),Yancey Brothers,10800,0,10800
"Braun, Mike",(R),Electronics Inc,10700,0,10700
"Braun, Mike",(R),FedEx Corp,10600,9500,1100
"Braun, Mike",(R),Kirby Risk Corp,10600,0,10600
"Braun, Mike",(R),St Vincent Medical Group,10600,0,10600
"Braun, Mike",(R),National Assn of Health Underwriters,10500,10500,0
"Braun, Mike",(R),"Hammond, Kennedy et al",10400,0,10400
"Braun, Mike",(R),Rogers Group,10400,0,10400
"Braun, Mike",(R),Sabin Metal,10400,0,10400
"Braun, Mike",(R),Stoops Buick Gmc,10400,0,10400
"Braun, Mike",(R),Welsh Realty,10400,0,10400
"Braun, Mike",(R),Gaylor Electric,10266,0,10266
"Braun, Mike",(R),Farbest Foods,10200,0,10200
"Braun, Mike",(R),Schahet Hotels,10200,0,10200
"Brown, Sherrod",(D),Ohio State University,259685,0,259685
"Brown, Sherrod",(D),League of Conservation Voters,208624,16999,191625
"Brown, Sherrod",(D),JStreetPAC,179872,9706,170166
"Brown, Sherrod",(D),Cleveland Clinic,139833,0,139833
"Brown, Sherrod",(D),Votesane PAC,117526,0,117526
"Brown, Sherrod",(D),Cleveland-Cliffs,110437,47400,63037
"Brown, Sherrod",(D),Case Western Reserve University,105724,0,105724
"Brown, Sherrod",(D),Nationwide,83231,33500,49731
"Brown, Sherrod",(D),Jones Day,81310,0,81310
"Brown, Sherrod",(D),Baker & Hostetler,69987,13500,56487
"Brown, Sherrod",(D),Thompson Hine LLP,65191,5000,60191
"Brown, Sherrod",(D),"Kohrman, Jackson & Krantz",64268,0,64268
"Brown, Sherrod",(D),Oberlin College,59264,0,59264
"Brown, Sherrod",(D),Prudential Financial,58925,29500,29425
"Brown, Sherrod",(D),America's Credit Unions,58405,52500,5905
"Brown, Sherrod",(D),Capital Group Companies,57913,20000,37913
"Brown, Sherrod",(D),New York Life Insurance,55902,34000,21902
"Brown, Sherrod",(D),Comcast Corp,55603,35000,20603
"Brown, Sherrod",(D),Analysis Group,53633,0,53633
"Brown, Sherrod",(D),National Education Assn,51854,40000,11854
"Brown, Sherrod",(D),State of Ohio,51310,0,51310
"Brown, Sherrod",(D),GOJO Industries,51000,0,51000
"Brown, Sherrod",(D),"Vorys, Sater et al",49126,6000,43126
"Brown, Sherrod",(D),University of Cincinnati,48936,0,48936
"Brown, Sherrod",(D),Sony Corp,48856,2000,46856
"Brown, Sherrod",(D),Nationwide Children's Hospital,46543,0,46543
"Brown, Sherrod",(D),Deloitte LLP,46539,40000,6539
"Brown, Sherrod",(D),United Food & Commercial Workers Union,46434,44948,1486
"Brown, Sherrod",(D),PricewaterhouseCoopers,46115,37500,8615
"Brown, Sherrod",(D),Mortgage Bankers Assn,46000,42500,3500
"Brown, Sherrod",(D),Children's Research & Education Institute,45800,0,45800
"Brown, Sherrod",(D),Cardinal Health,45716,30000,15716
"Brown, Sherrod",(D),International Brotherhood of Electrical Workers,45098,40000,5098
"Brown, Sherrod",(D),Goldman Sachs,44602,20000,24602
"Brown, Sherrod",(D),Procter & Gamble,44075,10000,34075
"Brown, Sherrod",(D),Squire Patton Boggs,43152,3500,39652
"Brown, Sherrod",(D),American Federation of Teachers,42468,41000,1468
"Brown, Sherrod",(D),American Federation of State/Cnty/Munic Employees,41439,40000,1439
"Brown, Sherrod",(D),Communications Workers of America,41124,40000,1124
"Brown, Sherrod",(D),Ernst & Young,40911,37500,3411
"Brown, Sherrod",(D),Dealer Tire,40750,0,40750
"Brown, Sherrod",(D),National Assn of Realtors,40500,39500,1000
"Brown, Sherrod",(D),American Assn for Justice,40250,40000,250
"Brown, Sherrod",(D),Tiber Creek Group,40220,0,40220
"Brown, Sherrod",(D),University of Akron,40124,0,40124
"Brown, Sherrod",(D),Air Line Pilots Assn,40085,40000,85
"Brown, Sherrod",(D),"Bakery, Confectionery, Tobacco & Grain Union",40000,40000,0
"Brown, Sherrod",(D),National Assn of Letter Carriers,40000,40000,0
"Brown, Sherrod",(D),National Assn of Real Estate Investment Trusts,40000,40000,0
"Brown, Sherrod",(D),National Multifamily Housing Council,40000,40000,0
"Brown, Sherrod",(D),Bank of America,39821,27500,12321
"Brown, Sherrod",(D),Cincinnati Children's Hospital Medical Center,39430,0,39430
"Brown, Sherrod",(D),Walt Disney Co,39251,1000,38251
"Brown, Sherrod",(D),United Steelworkers,38783,35000,3783
"Brown, Sherrod",(D),Burns & McDonnell,38500,38500,0
"Brown, Sherrod",(D),Alphabet Inc,38437,25000,13437
"Brown, Sherrod",(D),Thrivent Financial,37833,34833,3000
"Brown, Sherrod",(D),Subject Matter,37800,0,37800
"Brown, Sherrod",(D),Kent State University,37523,0,37523
"Brown, Sherrod",(D),Nucor Corp,37520,37000,520
"Brown, Sherrod",(D),Independent Insurance Agents & Brokers of America,37500,37500,0
"Brown, Sherrod",(D),Wine & Spirits Wholesalers of America,37500,37500,0
"Brown, Sherrod",(D),Williams & Jensen,36900,2000,34900
"Brown, Sherrod",(D),Wiley Rein LLP,36855,0,36855
"Brown, Sherrod",(D),KPMG LLP,36148,35500,648
"Brown, Sherrod",(D),"Akin, Gump et al",35775,750,35025
"Brown, Sherrod",(D),WPP plc,35001,0,35001
"Brown, Sherrod",(D),American Seniors Housing Assn,35000,35000,0
"Brown, Sherrod",(D),American Hospital Assn,34825,31500,3325
"Brown, Sherrod",(D),L Brands,34507,10000,24507
"Brown, Sherrod",(D),General Dynamics,34273,32000,2273
"Brown, Sherrod",(D),American Council of Life Insurers,33500,33500,0
"Brown, Sherrod",(D),Depository Trust & Clearing Corp,33350,29350,4000
"Brown, Sherrod",(D),American Health Care Assn,33000,25000,8000
"Brown, Sherrod",(D),MetroHealth System,32927,0,32927
"Brown, Sherrod",(D),Massachusetts Mutual Life Insurance,32650,30500,2150
"Brown, Sherrod",(D),American Federation of Government Employees,32546,32500,46
"Brown, Sherrod",(D),Huntington Bancshares,32503,20000,12503
"Brown, Sherrod",(D),"Williams, Hart et al",31600,0,31600
"Brown, Sherrod",(D),Machinists/Aerospace Workers Union,31590,30000,1590
"Brown, Sherrod",(D),Ford Motor Co,31565,27000,4565
"Brown, Sherrod",(D),National Air Traffic Controllers Assn,31500,31500,0
"Brown, Sherrod",(D),Honeywell International,31281,30500,781
"Brown, Sherrod",(D),National Community Pharmacists Assn,31000,31000,0
"Brown, Sherrod",(D),"English, Munger & Rice",30800,0,30800
"Brown, Sherrod",(D),S&P Global,30700,14000,16700
"Brown, Sherrod",(D),Alignment Government Strategies,30540,0,30540
"Brown, Sherrod",(D),Amsted Industries,30500,25500,5000
"Brown, Sherrod",(D),American Institute of CPAs,30250,30000,250
"Brown, Sherrod",(D),Invariant LLC,30200,0,30200
"Brown, Sherrod",(D),International Assn of Fire Fighters,30162,30000,162
"Brown, Sherrod",(D),National Assn of Home Builders,30010,30000,10
"Brown, Sherrod",(D),Amalgamated Bank,30000,30000,0
"Brown, Sherrod",(D),American Academy of Dermatology Assn,30000,30000,0
"Brown, Sherrod",(D),Bricklayers Union,30000,30000,0
"Brown, Sherrod",(D),Operating Engineers Union,30000,30000,0
"Brown, Sherrod",(D),UNITE HERE,29999,24999,5000
"Brown, Sherrod",(D),"BROWNSTEIN, HYATT et al",29960,6000,23960
"Brown, Sherrod",(D),Holland & Knight,29900,15500,14400
"Brown, Sherrod",(D),RLJ Management,29800,0,29800
"Burr, Richard",(R),British American Tobacco,147425,50000,97425
"Burr, Richard",(R),Dominion Energy,103600,37000,66600
"Burr, Richard",(R),Altria Group,92100,45000,47100
"Burr, Richard",(R),Duke Energy,76400,42000,34400
"Burr, Richard",(R),Northrop Grumman,70800,40500,30300
"Burr, Richard",(R),Metlife Inc,66100,20000,46100
"Burr, Richard",(R),Abbott Laboratories,63209,38000,25209
"Burr, Richard",(R),Southern Co,59400,44500,14900
"Burr, Richard",(R),Prudential Financial,57000,29000,28000
"Burr, Richard",(R),Ernst & Young,52150,30000,22150
"Burr, Richard",(R),Bank of America,51000,19500,31500
"Burr, Richard",(R),AT&T Inc,48650,48000,650
"Burr, Richard",(R),Fidelity Investments,46750,20000,26750
"Burr, Richard",(R),Lowe's Companies,46300,24000,22300
"Burr, Richard",(R),Pfizer Inc,45800,35000,10800
"Burr, Richard",(R),Premier Inc,45682,20000,25682
"Burr, Richard",(R),Nucor Corp,44350,15000,29350
"Burr, Richard",(R),Massachusetts Mutual Life Insurance,44200,21500,22700
"Burr, Richard",(R),Blue Cross/Blue Shield,43050,20000,23050
"Burr, Richard",(R),General Electric,41350,11000,30350
"Burr, Richard",(R),National Assn of Real Estate Investment Trusts,41000,40000,1000
"Burr, Richard",(R),Elliott Management,40400,0,40400
"Burr, Richard",(R),Womble Bond Dickinson,40350,0,40350
"Burr, Richard",(R),RTX Corp,38700,37000,1700
"Burr, Richard",(R),Live Oak Bank,38100,0,38100
"Burr, Richard",(R),Verizon Communications,37700,30000,7700
"Burr, Richard",(R),EmergeOrtho,37200,9600,27600
"Burr, Richard",(R),Deloitte LLP,36500,35000,1500
"Burr, Richard",(R),Merck & Co,35750,35000,750
"Burr, Richard",(R),McGuireWoods LLP,35700,10000,25700
"Burr, Richard",(R),Boston Scientific Corp,35100,20000,15100
"Burr, Richard",(R),Automotive Free International Trade PAC,35000,35000,0
"Burr, Richard",(R),Honeywell International,35000,35000,0
"Burr, Richard",(R),National Assn of Realtors,35000,35000,0
"Burr, Richard",(R),FedEx Corp,34900,28500,6400
"Burr, Richard",(R),Norfolk Southern,34500,34500,0
"Burr, Richard",(R),Swisher International,34500,27500,7000
"Burr, Richard",(R),Capital Group Companies,34400,18000,16400
"Burr, Richard",(R),1st Financial Bank USA,33930,0,33930
"Burr, Richard",(R),Pinnacle West Capital,33000,33000,0
"Burr, Richard",(R),Clean Energy Fuels Corp,32650,0,32650
"Burr, Richard",(R),CSX Corp,32500,32500,0
"Burr, Richard",(R),UnitedHealth Group,32500,25500,7000
"Burr, Richard",(R),United Parcel Service,31900,31500,400
"Burr, Richard",(R),Truist Financial,31650,16000,15650
"Burr, Richard",(R),American Assn of Orthodontists,31500,31500,0
"Burr, Richard",(R),Google Inc,31090,30000,1090
"Burr, Richard",(R),Wake Forest Baptist Medical Center,30700,0,30700
"Burr, Richard",(R),Lockheed Martin,30500,29000,1500
"Burr, Richard",(R),General Dynamics,30250,30000,250
"Burr, Richard",(R),Boeing Co,30000,30000,0
"Burr, Richard",(R),McKesson Corp,30000,30000,0
"Burr, Richard",(R),National Assn of Convenience Stores,30000,30000,0
"Burr, Richard",(R),Woodbranch Investments,30000,0,30000
"Burr, Richard",(R),Comcast Corp,29500,26000,3500
"Burr, Richard",(R),DaVita Inc,29400,13000,16400
"Burr, Richard",(R),Blackstone Group,29300,0,29300
"Burr, Richard",(R),Ford Motor Co,28500,17500,11000
"Burr, Richard",(R),Occidental Petroleum,28300,15000,13300
"Burr, Richard",(R),Fierce Government Relations,28050,0,28050
"Burr, Richard",(R),American College of Radiology,27500,27500,0
"Burr, Richard",(R),International Paper,27500,27500,0
"Burr, Richard",(R),National Multifamily Housing Council,27500,27500,0
"Burr, Richard",(R),GlaxoSmithKline,26950,12500,14450
"Burr, Richard",(R),New Jersey Urology,26250,0,26250
"Burr, Richard",(R),Publix Super Markets,25800,15000,10800
"Burr, Richard",(R),Eli Lilly & Co,25700,17000,8700
"Burr, Richard",(R),National Beer Wholesalers Assn,25500,25500,0
"Burr, Richard",(R),Alston & Bird,25141,10000,15141
"Burr, Richard",(R),American Dental Assn,25000,25000,0
"Burr, Richard",(R),California Dairies Inc,25000,25000,0
"Burr, Richard",(R),CME Group,25000,17000,8000
"Burr, Richard",(R),General Atomics,25000,1500,23500
"Burr, Richard",(R),Home Depot,25000,25000,0
"Burr, Richard",(R),National Assn of Broadcasters,25000,25000,0
"Burr, Richard",(R),Union Pacific Corp,25000,25000,0
"Burr, Richard",(R),Wells Fargo,24650,10000,14650
"Burr, Richard",(R),Alpine Group,24616,0,24616
"Burr, Richard",(R),Purdue Pharma,24247,18000,6247
"Burr, Richard",(R),BGR Group,24177,2477,21700
"Burr, Richard",(R),UBS AG,23700,20000,3700
"Burr, Richard",(R),Emergent BioSolutions,23500,10000,13500
"Burr, Richard",(R),Genworth Financial,23450,20000,3450
"Burr, Richard",(R),Law Offices of Frederick H Graefe,23315,0,23315
"Burr, Richard",(R),Ward & Smith,22850,9500,13350
"Burr, Richard",(R),Humana Inc,22500,22500,0
"Burr, Richard",(R),TIAA,22500,21500,1000
"Burr, Richard",(R),Wine & Spirits Wholesalers of America,22500,22500,0
"Burr, Richard",(R),Glen Raven Inc,21850,0,21850
"Burr, Richard",(R),Northwestern Mutual,21800,2500,19300
"Burr, Richard",(R),Alex Lee Inc,21700,10000,11700
"Burr, Richard",(R),Amway/Alticor Inc,21600,0,21600
"Burr, Richard",(R),Heller Realty,21600,0,21600
"Burr, Richard",(R),Meridian Capital,21600,0,21600
"Burr, Richard",(R),American Hotel & Lodging Assn,21500,21500,0
"Burr, Richard",(R),Ryan LLC,21400,10000,11400
"Burr, Richard",(R),DLA Piper,21365,6000,15365
"Burr, Richard",(R),NASCAR,21100,10000,11100
"Burr, Richard",(R),American Financial Group,21000,0,21000
"Burr, Richard",(R),KPMG LLP,20200,17500,2700
"Cantwell, Maria",(D),Microsoft Corp,116119,0,116119
"Cantwell, Maria",(D),Morgan & Morgan,113400,0,113400
"Cantwell, Maria",(D),League of Conservation Voters,100823,-37,100860
"Cantwell, Maria",(D),University of Washington,75163,0,75163
"Cantwell, Maria",(D),Boeing Co,68685,0,68685
"Cantwell, Maria",(D),Amazon.com,59240,0,59240
"Cantwell, Maria",(D),EMILY's List,45756,0,45756
"Cantwell, Maria",(D),Democracy Engine,43800,0,43800
"Cantwell, Maria",(D),State of Washington,37422,0,37422
"Cantwell, Maria",(D),Zillow Group,37025,0,37025
"Cantwell, Maria",(D),Valve Corp,26850,0,26850
"Cantwell, Maria",(D),Fedex Corp,24601,0,24601
"Cantwell, Maria",(D),K&L Gates,24020,0,24020
"Cantwell, Maria",(D),Royal Bank of Canada,21700,0,21700
"Cantwell, Maria",(D),Fisher Investments,20000,0,20000
"Cantwell, Maria",(D),Carnival Corp,19910,0,19910
"Cantwell, Maria",(D),"Orrick, Herrington & Sutcliffe",19450,0,19450
"Cantwell, Maria",(D),Strategies 360,19450,0,19450
"Cantwell, Maria",(D),Womencount PAC,19030,0,19030
"Cantwell, Maria",(D),Costco Wholesale,18388,0,18388
"Cantwell, Maria",(D),Capitol Counsel,18200,0,18200
"Cantwell, Maria",(D),Novogradac & Co,18200,0,18200
"Cantwell, Maria",(D),Hudson Housing Capital,17800,0,17800
"Cantwell, Maria",(D),Intellectual Ventures LLC,17715,0,17715
"Cantwell, Maria",(D),Meta,17475,0,17475
"Cantwell, Maria",(D),Delta Dental Plans Assn,17093,0,17093
"Cantwell, Maria",(D),PG&E Corp,16750,0,16750
"Cantwell, Maria",(D),Second Avenue Partners,16600,0,16600
"Cantwell, Maria",(D),NextEra Energy,16010,0,16010
"Cantwell, Maria",(D),Korein Tillery LLC,15800,0,15800
"Cantwell, Maria",(D),Trident Seafoods,15450,0,15450
"Cantwell, Maria",(D),Bill & Melinda Gates Foundation,14750,0,14750
"Cantwell, Maria",(D),Carlyle Group,14350,0,14350
"Cantwell, Maria",(D),Madrona Venture Group,14237,0,14237
"Cantwell, Maria",(D),Weyerhaeuser Co,14085,0,14085
"Cantwell, Maria",(D),Lumen Technologies,14060,0,14060
"Cantwell, Maria",(D),Subject Matter,13900,0,13900
"Cantwell, Maria",(D),Holland & Knight,13750,0,13750
"Cantwell, Maria",(D),"Bergman, Draper et al",13700,0,13700
"Cantwell, Maria",(D),IEH Laboratories,13700,0,13700
"Cantwell, Maria",(D),Audacy Inc,13500,0,13500
"Cantwell, Maria",(D),Alpine Group,13450,0,13450
"Cantwell, Maria",(D),Forbes Tate Partners,13259,0,13259
"Cantwell, Maria",(D),Greater New York Hospital Assn,13200,0,13200
"Cantwell, Maria",(D),"Sonosky, Chambers et al",13150,0,13150
"Cantwell, Maria",(D),Squire Patton Boggs,13100,0,13100
"Cantwell, Maria",(D),Cornerstone Government Affairs,11800,0,11800
"Cantwell, Maria",(D),Washington State University,11619,0,11619
"Cantwell, Maria",(D),Vulcan Materials,11160,0,11160
"Cantwell, Maria",(D),Alliant Capital,11050,0,11050
"Cantwell, Maria",(D),Saltchuk Resources,11000,0,11000
"Cantwell, Maria",(D),Bain Capital,10839,0,10839
"Cantwell, Maria",(D),Blume Co,10800,0,10800
"Cantwell, Maria",(D),Broadmark Capital,10800,0,10800
"Cantwell, Maria",(D),Children's Research & Education Institute,10800,0,10800
"Cantwell, Maria",(D),Connell Co,10800,0,10800
"Cantwell, Maria",(D),DISH Network,10800,0,10800
"Cantwell, Maria",(D),Far Star Ventures,10800,0,10800
"Cantwell, Maria",(D),"Kleiner, Perkins et al",10800,0,10800
"Cantwell, Maria",(D),Martin Selig Real Estate,10800,0,10800
"Cantwell, Maria",(D),Prospect Hotel Advisors,10800,0,10800
"Cantwell, Maria",(D),Quilceda Creek Vintners,10800,0,10800
"Cantwell, Maria",(D),Raikes Foundation,10800,0,10800
"Cantwell, Maria",(D),Sidney Kohl Co,10800,0,10800
"Cantwell, Maria",(D),Covanta Holding,10750,0,10750
"Cantwell, Maria",(D),Virginia Mason Medical Center,10709,0,10709
"Cantwell, Maria",(D),Power Rogers LLP,10600,0,10600
"Cantwell, Maria",(D),Puget Sound Energy,10480,0,10480
"Cantwell, Maria",(D),Centene Corp,10400,0,10400
"Cantwell, Maria",(D),DaVita Inc,10203,0,10203
"Cantwell, Maria",(D),Gordon Thomas Honeywell LLP,10100,0,10100
"Cantwell, Maria",(D),Tableau Software,10035,0,10035
"Cantwell, Maria",(D),Consonus Healthcare,10000,0,10000
"Cantwell, Maria",(D),Goldman Sachs,10000,0,10000
"Cantwell, Maria",(D),Vaagen Brothers Lumber,10000,0,10000
"Cantwell, Maria",(D),Pisces Inc,9900,0,9900
"Cantwell, Maria",(D),Lesmir,9800,0,9800
"Cantwell, Maria",(D),JStreetPAC,9600,0,9600
"Cantwell, Maria",(D),TPG Capital,9600,0,9600
"Cantwell, Maria",(D),Accolade Inc,9500,0,9500
"Cantwell, Maria",(D),HLP&R Advocacy,9500,0,9500
"Cantwell, Maria",(D),"City of Seattle, WA",9418,0,9418
"Cantwell, Maria",(D),Pacific Companies (Idaho),9400,0,9400
"Cantwell, Maria",(D),Fred Hutchinson Cancer Center,9314,0,9314
"Cantwell, Maria",(D),Swedish Health Services,9232,0,9232
"Cantwell, Maria",(D),University of Washington Medicine,9091,0,9091
"Cantwell, Maria",(D),Potelco Inc,8900,0,8900
"Cantwell, Maria",(D),Red Stone Equity Partners,8900,0,8900
"Cantwell, Maria",(D),Van Ness Feldman,8875,0,8875
"Cantwell, Maria",(D),Baupost Group,8850,0,8850
"Cantwell, Maria",(D),Hogan Lovells,8600,0,8600
"Cantwell, Maria",(D),Delta Air Lines,8530,0,8530
"Cantwell, Maria",(D),Cassidy & Assoc,8525,0,8525
"Cantwell, Maria",(D),"Akin, Gump et al",8502,0,8502
"Cantwell, Maria",(D),National Assn of Broadcasters,8500,0,8500
"Cantwell, Maria",(D),Molecular Epidemiology,8300,0,8300
"Cantwell, Maria",(D),Ballmer Group,8200,0,8200
"Cantwell, Maria",(D),"Bocarsly, Emden et al",8100,0,8100
"Cantwell, Maria",(D),Clifford Law Offices,8100,0,8100
"Cantwell, Maria",(D),Cooney & Conway,8100,0,8100
"Capito, Shelley Moore",(R),FirstEnergy Corp,81300,40000,41300
"Capito, Shelley Moore",(R),Dominion Energy,52100,37500,14600
"Capito, Shelley Moore",(R),GEO Group,51000,15000,36000
"Capito, Shelley Moore",(R),Mortgage Bankers Assn,41000,41000,0
"Capito, Shelley Moore",(R),Honeywell International,40150,40000,150
"Capito, Shelley Moore",(R),United Parcel Service,40080,40000,80
"Capito, Shelley Moore",(R),National Auto Dealers Assn,40000,40000,0
"Capito, Shelley Moore",(R),National Multifamily Housing Council,40000,40000,0
"Capito, Shelley Moore",(R),DISH Network,39050,22000,17050
"Capito, Shelley Moore",(R),Union Pacific Corp,38000,37500,500
"Capito, Shelley Moore",(R),Williams Companies,36800,20000,16800
"Capito, Shelley Moore",(R),Deloitte LLP,36625,35500,1125
"Capito, Shelley Moore",(R),Elliott Management,36500,0,36500
"Capito, Shelley Moore",(R),Berkshire Hathaway,36050,35000,1050
"Capito, Shelley Moore",(R),Delta Air Lines,35575,17500,18075
"Capito, Shelley Moore",(R),CSX Corp,35000,35000,0
"Capito, Shelley Moore",(R),Northrop Grumman,33515,33500,15
"Capito, Shelley Moore",(R),Comcast Corp,31462,30000,1462
"Capito, Shelley Moore",(R),Ernst & Young,30000,30000,0
"Capito, Shelley Moore",(R),National Beer Wholesalers Assn,30000,30000,0
"Capito, Shelley Moore",(R),Norfolk Southern,30000,30000,0
"Capito, Shelley Moore",(R),Sullivan & Cromwell,30000,0,30000
"Capito, Shelley Moore",(R),Wine & Spirits Wholesalers of America,30000,30000,0
"Capito, Shelley Moore",(R),General Motors,29275,28500,775
"Capito, Shelley Moore",(R),AT&T Inc,29036,29000,36
"Capito, Shelley Moore",(R),Jennmar Corp,28000,0,28000
"Capito, Shelley Moore",(R),FedEx Corp,27024,27000,24
"Capito, Shelley Moore",(R),UnitedHealth Group,26100,20500,5600
"Capito, Shelley Moore",(R),National Community Pharmacists Assn,26000,26000,0
"Capito, Shelley Moore",(R),NorPAC,25500,0,25500
"Capito, Shelley Moore",(R),Google Inc,25075,25000,75
"Capito, Shelley Moore",(R),National Assn of Chemical Distributors,25000,25000,0
"Capito, Shelley Moore",(R),Toyota Motor North America,25000,25000,0
"Capito, Shelley Moore",(R),Centene Corp,24300,2500,21800
"Capito, Shelley Moore",(R),American Hospital Assn,24000,20000,4000
"Capito, Shelley Moore",(R),National Assn of Broadcasters,24000,23000,1000
"Capito, Shelley Moore",(R),PricewaterhouseCoopers,23510,23500,10
"Capito, Shelley Moore",(R),KPMG LLP,23500,23500,0
"Capito, Shelley Moore",(R),Telephone & Data Systems Inc,22700,20000,2700
"Capito, Shelley Moore",(R),International Franchise Assn,22500,22500,0
"Capito, Shelley Moore",(R),Charter Communications,22000,20000,2000
"Capito, Shelley Moore",(R),Ergon Inc,21700,0,21700
"Capito, Shelley Moore",(R),New York Life Insurance,20425,20000,425
"Capito, Shelley Moore",(R),Alpha Metallurgical Resources,20400,15000,5400
"Capito, Shelley Moore",(R),Civic Service Inc,20400,0,20400
"Capito, Shelley Moore",(R),Laborers Union,20030,20000,30
"Capito, Shelley Moore",(R),Home Depot,20010,20000,10
"Capito, Shelley Moore",(R),Independent Community Bankers of America,20000,20000,0
"Capito, Shelley Moore",(R),Koch Industries,20000,20000,0
"Capito, Shelley Moore",(R),Leidos Inc,20000,20000,0
"Capito, Shelley Moore",(R),National Assn of Realtors,20000,20000,0
"Capito, Shelley Moore",(R),Capital Counsel,19600,0,19600
"Capito, Shelley Moore",(R),Senior Star,19600,0,19600
"Capito, Shelley Moore",(R),RDV Corp,19500,0,19500
"Capito, Shelley Moore",(R),Goldman Sachs,19000,2500,16500
"Capito, Shelley Moore",(R),Amazon.com,18502,18500,2
"Capito, Shelley Moore",(R),Bank of America,18500,6500,12000
"Capito, Shelley Moore",(R),Blue Cross/Blue Shield,18500,18500,0
"Capito, Shelley Moore",(R),Rite Aid Corp,18500,17500,1000
"Capito, Shelley Moore",(R),Blackstone Group,18400,0,18400
"Capito, Shelley Moore",(R),DuPont Co,18255,18000,255
"Capito, Shelley Moore",(R),Huntington Ingalls Industries,18000,18000,0
"Capito, Shelley Moore",(R),American College of Emergency Physicians,17500,17500,0
"Capito, Shelley Moore",(R),Massachusetts Mutual Life Insurance,17000,17000,0
"Capito, Shelley Moore",(R),NCTA The Internet & Television Assn,17000,17000,0
"Capito, Shelley Moore",(R),Ornstein-Schuler Companies,16800,0,16800
"Capito, Shelley Moore",(R),K&L Gates,16562,9250,7312
"Capito, Shelley Moore",(R),Pfizer Inc,16025,16000,25
"Capito, Shelley Moore",(R),America's Credit Unions,16000,16000,0
"Capito, Shelley Moore",(R),"National Stone, Sand & Gravel Assn",16000,16000,0
"Capito, Shelley Moore",(R),Walmart Inc,15535,15500,35
"Capito, Shelley Moore",(R),Air Line Pilots Assn,15500,15500,0
"Capito, Shelley Moore",(R),Steptoe & Johnson,15300,0,15300
"Capito, Shelley Moore",(R),Merck & Co,15250,15000,250
"Capito, Shelley Moore",(R),General Dynamics,15145,15000,145
"Capito, Shelley Moore",(R),American Hotel & Lodging Assn,15000,15000,0
"Capito, Shelley Moore",(R),Automotive Free International Trade PAC,15000,15000,0
"Capito, Shelley Moore",(R),International Assn of Fire Fighters,15000,15000,0
"Capito, Shelley Moore",(R),International Paper,15000,15000,0
"Capito, Shelley Moore",(R),Koch Inc,15000,15000,0
"Capito, Shelley Moore",(R),Marathon Petroleum,15000,15000,0
"Capito, Shelley Moore",(R),National Active & Retired Federal Employees Assn,15000,15000,0
"Capito, Shelley Moore",(R),National Rural Electric Cooperative Assn,15000,15000,0
"Capito, Shelley Moore",(R),Operating Engineers Union,15000,15000,0
"Capito, Shelley Moore",(R),Valero Energy,15000,15000,0
"Capito, Shelley Moore",(R),Value in Electing Women PAC,15000,15000,0
"Capito, Shelley Moore",(R),Blackstone,14000,0,14000
"Capito, Shelley Moore",(R),PNC Financial Services,14000,14000,0
"Capito, Shelley Moore",(R),Ford Motor Co,13535,13500,35
"Capito, Shelley Moore",(R),T-Mobile USA,13510,13500,10
"Capito, Shelley Moore",(R),American Dental Assn,13500,13000,500
"Capito, Shelley Moore",(R),Microsoft Corp,13175,7500,5675
"Capito, Shelley Moore",(R),Raytheon Technologies,13060,13000,60
"Capito, Shelley Moore",(R),AFLAC Inc,13000,13000,0
"Capito, Shelley Moore",(R),National Air Traffic Controllers Assn,13000,13000,0
"Capito, Shelley Moore",(R),National Roofing Contractors Assn,13000,13000,0
"Capito, Shelley Moore",(R),American Bankers Assn,12525,12500,25
"Capito, Shelley Moore",(R),National Assn of Convenience Stores,12500,12500,0
"Capito, Shelley Moore",(R),National Assn of Real Estate Investment Trusts,12500,12500,0
"Capito, Shelley Moore",(R),National Electrical Contractors Assn,12500,12500,0
"Cardin, Ben",(D),Blue Cross/Blue Shield,64025,42500,21525
"Cardin, Ben",(D),Lockheed Martin,48700,25000,23700
"Cardin, Ben",(D),NorPAC,47200,0,47200
"Cardin, Ben",(D),Northrop Grumman,45005,45000,5
"Cardin, Ben",(D),National Assn of Real Estate Investment Trusts,43900,39500,4400
"Cardin, Ben",(D),International Brotherhood of Electrical Workers,40000,40000,0
"Cardin, Ben",(D),Exelon Corp,39500,38500,1000
"Cardin, Ben",(D),National Assn of Realtors,37500,37500,0
"Cardin, Ben",(D),American College of Emergency Physicians,36000,36000,0
"Cardin, Ben",(D),United Parcel Service,31000,31000,0
"Cardin, Ben",(D),American College of Radiology,30000,30000,0
"Cardin, Ben",(D),Massachusetts Mutual Life Insurance,29500,24500,5000
"Cardin, Ben",(D),Metlife Inc,27500,26500,1000
"Cardin, Ben",(D),Comcast Corp,26500,26500,0
"Cardin, Ben",(D),Fidelity Investments,26000,25000,1000
"Cardin, Ben",(D),RTX Corp,25000,25000,0
"Cardin, Ben",(D),"Sheet Metal, Air, Rail & Transportation Union",25000,25000,0
"Cardin, Ben",(D),Guardian Life Insurance,24750,11000,13750
"Cardin, Ben",(D),American Hospital Assn,24500,24000,500
"Cardin, Ben",(D),Honeywell International,23100,22500,600
"Cardin, Ben",(D),American Seniors Housing Assn,22500,22500,0
"Cardin, Ben",(D),Pakistani American Public Affairs Cmte,22500,17750,4750
"Cardin, Ben",(D),Delaware Valley Urology,22250,0,22250
"Cardin, Ben",(D),Northwestern Mutual Life Insurance,22250,21000,1250
"Cardin, Ben",(D),Deloitte LLP,21510,20000,1510
"Cardin, Ben",(D),Apollo Global Management,21200,3000,18200
"Cardin, Ben",(D),Wine & Spirits Wholesalers of America,20500,20500,0
"Cardin, Ben",(D),Google Inc,20006,20000,6
"Cardin, Ben",(D),American Assn for Justice,20000,20000,0
"Cardin, Ben",(D),American Psychiatric Assn,20000,20000,0
"Cardin, Ben",(D),Select Medical Corp,20000,10000,10000
"Cardin, Ben",(D),Prudential Financial,19500,19500,0
"Cardin, Ben",(D),"Brownstein, Hyatt et al",19100,6000,13100
"Cardin, Ben",(D),Kidney Care Partners,19000,19000,0
"Cardin, Ben",(D),American Dental Assn,18500,18500,0
"Cardin, Ben",(D),General Motors,18500,18500,0
"Cardin, Ben",(D),National Air Traffic Controllers Assn,18500,18500,0
"Cardin, Ben",(D),National Multifamily Housing Council,18500,18500,0
"Cardin, Ben",(D),Marriott International,17500,12500,5000
"Cardin, Ben",(D),McKesson Corp,17500,17500,0
"Cardin, Ben",(D),National Beer Wholesalers Assn,17500,17500,0
"Cardin, Ben",(D),American Health Care Assn,17250,16000,1250
"Cardin, Ben",(D),Discovery Inc,17200,0,17200
"Cardin, Ben",(D),TransAmerica,17200,14500,2700
"Cardin, Ben",(D),Pacific Life Insurance,17000,16000,1000
"Cardin, Ben",(D),AstraZeneca Pharmaceuticals,16500,16500,0
"Cardin, Ben",(D),American Society of Anesthesiologists,16000,16000,0
"Cardin, Ben",(D),Fresenius Medical Care North America,16000,16000,0
"Cardin, Ben",(D),American Soc/Pension Prof & Actuaries,15500,15500,0
"Cardin, Ben",(D),Bayada Home Health Care,15050,15050,0
"Cardin, Ben",(D),American Academy of Family Physicians,15000,15000,0
"Cardin, Ben",(D),American Hotel & Lodging Assn,15000,15000,0
"Cardin, Ben",(D),National Assn of Letter Carriers,15000,15000,0
"Cardin, Ben",(D),Teamsters Union,15000,15000,0
"Cardin, Ben",(D),Genesis HealthCare,14750,12500,2250
"Cardin, Ben",(D),Ernst & Young,14700,8000,6700
"Cardin, Ben",(D),American Institute of CPAs,14500,14500,0
"Cardin, Ben",(D),American Speech-Language-Hearing Assn,14000,14000,0
"Cardin, Ben",(D),Comtech TeleCommunications,14000,14000,0
"Cardin, Ben",(D),Michael Companies,14000,0,14000
"Cardin, Ben",(D),"Akin, Gump et al",13718,3968,9750
"Cardin, Ben",(D),HBJ Investments,13500,0,13500
"Cardin, Ben",(D),CVS Health,13200,9500,3700
"Cardin, Ben",(D),Liberty Partners Group,13000,0,13000
"Cardin, Ben",(D),American Orthotic & Prosthetic Assn,12874,10000,2874
"Cardin, Ben",(D),Pfizer Inc,12500,12500,0
"Cardin, Ben",(D),League of Conservation Voters,12033,12033,0
"Cardin, Ben",(D),Equipment Leasing & Finance Assn,12000,12000,0
"Cardin, Ben",(D),Franklin Morris & Assoc,11600,0,11600
"Cardin, Ben",(D),Laureate Education,11550,0,11550
"Cardin, Ben",(D),"Buchanan, Ingersoll & Rooney",11500,3500,8000
"Cardin, Ben",(D),ESOP Assn,11500,11500,0
"Cardin, Ben",(D),Shelter Group,11400,0,11400
"Cardin, Ben",(D),WilmerHale LLP,11039,0,11039
"Cardin, Ben",(D),CSX Corp,11000,11000,0
"Cardin, Ben",(D),Fraternity & Sorority PAC,11000,11000,0
"Cardin, Ben",(D),Major League Baseball Commissioner's Ofc,11000,11000,0
"Cardin, Ben",(D),Marine Engineers Beneficial Assn,11000,11000,0
"Cardin, Ben",(D),New York Life Insurance,11000,11000,0
"Cardin, Ben",(D),Renal Physicians Assn,11000,11000,0
"Cardin, Ben",(D),Chesapeake Shipbuilding,10800,0,10800
"Cardin, Ben",(D),DISH Network,10800,0,10800
"Cardin, Ben",(D),Harvy's Car Wash,10800,0,10800
"Cardin, Ben",(D),Landow & Co,10800,0,10800
"Cardin, Ben",(D),Mica Corp,10800,0,10800
"Cardin, Ben",(D),Nimeks Organics,10800,0,10800
"Cardin, Ben",(D),Sinclair Broadcast Group,10800,0,10800
"Cardin, Ben",(D),T Rowe Price,10800,0,10800
"Cardin, Ben",(D),Triumvirate Environmental,10800,0,10800
"Cardin, Ben",(D),AT&T Inc,10250,9500,750
"Cardin, Ben",(D),Boeing Co,10025,10000,25
"Cardin, Ben",(D),America Works,10000,10000,0
"Cardin, Ben",(D),American Academy of Pediatric Dentistry,10000,10000,0
"Cardin, Ben",(D),American Assn of Nurse Practitioners,10000,10000,0
"Cardin, Ben",(D),American Council of Life Insurers,10000,10000,0
"Cardin, Ben",(D),American Federation of Government Employees,10000,10000,0
"Cardin, Ben",(D),American Federation of Teachers,10000,10000,0
"Cardin, Ben",(D),Amgen Inc,10000,10000,0
"Cardin, Ben",(D),Bi-County PAC,10000,10000,0
"Cardin, Ben",(D),BlackRock Inc,10000,10000,0
"Carper, Tom",(D),MetLife Inc,74200,25000,49200
"Carper, Tom",(D),Blue Cross/Blue Shield,62900,51500,11400
"Carper, Tom",(D),Goldman Sachs,58725,40000,18725
"Carper, Tom",(D),Democracy Engine,51249,0,51249
"Carper, Tom",(D),Merck & Co,50655,37500,13155
"Carper, Tom",(D),JPMorgan Chase & Co,48875,35000,13875
"Carper, Tom",(D),AstraZeneca Pharmaceuticals,46100,45000,1100
"Carper, Tom",(D),Visa Inc,45900,32500,13400
"Carper, Tom",(D),Amgen Inc,44900,39500,5400
"Carper, Tom",(D),DuPont Co,41293,13000,28293
"Carper, Tom",(D),United Parcel Service,41250,41000,250
"Carper, Tom",(D),Deloitte LLP,40000,40000,0
"Carper, Tom",(D),Honeywell International,40000,40000,0
"Carper, Tom",(D),National Multifamily Housing Council,40000,40000,0
"Carper, Tom",(D),American Seniors Housing Assn,38000,38000,0
"Carper, Tom",(D),Google Inc,38000,38000,0
"Carper, Tom",(D),National Assn of Real Estate Investment Trusts,37500,37500,0
"Carper, Tom",(D),UBS Americas,37500,37500,0
"Carper, Tom",(D),USAA,37500,37500,0
"Carper, Tom",(D),Comcast Corp,35000,35000,0
"Carper, Tom",(D),Investment Co Institute,35000,35000,0
"Carper, Tom",(D),Operating Engineers Union,35000,35000,0
"Carper, Tom",(D),PG&E Corp,35000,35000,0
"Carper, Tom",(D),Exelon Corp,34941,32500,2441
"Carper, Tom",(D),National Assn of Realtors,34000,34000,0
"Carper, Tom",(D),New York Life Insurance,34000,27500,6500
"Carper, Tom",(D),Pfizer Inc,34000,29000,5000
"Carper, Tom",(D),Ernst & Young,33272,33000,272
"Carper, Tom",(D),Sanofi,32900,27500,5400
"Carper, Tom",(D),American Institute of CPAs,32500,32500,0
"Carper, Tom",(D),Independent Community Bankers of America,32307,32000,307
"Carper, Tom",(D),American Health Care Assn,32218,32000,218
"Carper, Tom",(D),AT&T Inc,31045,31000,45
"Carper, Tom",(D),"Kleiner, Perkins et al",30900,0,30900
"Carper, Tom",(D),FedEx Corp,30670,30000,670
"Carper, Tom",(D),eHealth Inc,30200,21000,9200
"Carper, Tom",(D),American Council of Engineering Cos,30000,30000,0
"Carper, Tom",(D),Mortgage Bankers Assn,30000,30000,0
"Carper, Tom",(D),AbbVie Inc,29000,29000,0
"Carper, Tom",(D),Northrop Grumman,29000,28500,500
"Carper, Tom",(D),Capital Group Companies,28500,28500,0
"Carper, Tom",(D),Hallmark Cards,28500,9000,19500
"Carper, Tom",(D),America's Credit Unions,28000,28000,0
"Carper, Tom",(D),American Bankers Assn,27500,27500,0
"Carper, Tom",(D),Discover Financial Services,27185,8680,18505
"Carper, Tom",(D),Bank of America,27167,24000,3167
"Carper, Tom",(D),Blackstone Group,27000,5000,22000
"Carper, Tom",(D),Consumer Bankers Assn,26000,26000,0
"Carper, Tom",(D),PNC Financial Services,25685,25500,185
"Carper, Tom",(D),AFLAC Inc,25000,25000,0
"Carper, Tom",(D),National Beer Wholesalers Assn,25000,25000,0
"Carper, Tom",(D),Eli Lilly & Co,23700,21000,2700
"Carper, Tom",(D),Microsoft Corp,23100,23000,100
"Carper, Tom",(D),Walmart Inc,23000,23000,0
"Carper, Tom",(D),BASF Corp,22710,22500,210
"Carper, Tom",(D),Sallie Mae,22700,22700,0
"Carper, Tom",(D),CSX Corp,22500,22500,0
"Carper, Tom",(D),Bristol-Myers Squibb,22200,19700,2500
"Carper, Tom",(D),Entergy Corp,22000,22000,0
"Carper, Tom",(D),Finseca,22000,22000,0
"Carper, Tom",(D),American Express,21000,21000,0
"Carper, Tom",(D),Loews Corp,20700,12500,8200
"Carper, Tom",(D),"Welsh, Carson et al",20600,0,20600
"Carper, Tom",(D),"Akin, Gump et al",20500,3250,17250
"Carper, Tom",(D),Capital One Financial,20013,20000,13
"Carper, Tom",(D),Holland & Knight,20000,16000,4000
"Carper, Tom",(D),Calpine Corp,19500,19500,0
"Carper, Tom",(D),Massachusetts Mutual Life Insurance,19500,19500,0
"Carper, Tom",(D),"National Stone, Sand & Gravel Assn",19500,19500,0
"Carper, Tom",(D),Bowles & Co,18300,0,18300
"Carper, Tom",(D),International Paper,18000,18000,0
"Carper, Tom",(D),League of Conservation Voters,17900,12500,5400
"Carper, Tom",(D),American Hotel & Lodging Assn,17500,17500,0
"Carper, Tom",(D),American Trucking Assns,17500,16500,1000
"Carper, Tom",(D),AmerisourceBergen Corp,17500,17500,0
"Carper, Tom",(D),California Dairies Inc,17500,17500,0
"Carper, Tom",(D),College of American Pathologists,17000,17000,0
"Carper, Tom",(D),Lockheed Martin,17000,17000,0
"Carper, Tom",(D),PricewaterhouseCoopers,17000,17000,0
"Carper, Tom",(D),Amazon.com,16815,16500,315
"Carper, Tom",(D),National Assn of Letter Carriers,16500,16500,0
"Carper, Tom",(D),Ashland Inc,16400,12000,4400
"Carper, Tom",(D),General Motors,16031,16000,31
"Carper, Tom",(D),"Young, Conaway et al",15800,0,15800
"Carper, Tom",(D),Marsh & McLennan,15500,15500,0
"Carper, Tom",(D),NCTA The Internet & Television Assn,15500,15500,0
"Carper, Tom",(D),Aetna Inc,15000,15000,0
"Carper, Tom",(D),American Chemistry Council,15000,15000,0
"Carper, Tom",(D),BNSF Railway,15000,15000,0
"Carper, Tom",(D),Credit Suisse Securities,15000,15000,0
"Carper, Tom",(D),National Apartment Assn,15000,15000,0
"Carper, Tom",(D),Sunovion Pharmaceuticals,15000,15000,0
"Carper, Tom",(D),US Acute Care Solutions,15000,5000,10000
"Carper, Tom",(D),Dominion Energy,14500,14500,0
"Carper, Tom",(D),FMR Corp,14500,14500,0
"Carper, Tom",(D),Wells Fargo,14270,10000,4270
"Carper, Tom",(D),Electronic Transactions Assn,14000,14000,0
"Carper, Tom",(D),Growth Energy,14000,14000,0
"Carper, Tom",(D),Hartford Financial Services,14000,14000,0
"Carper, Tom",(D),Blackrock Funds Services Group,13500,13500,0
"Casey, Bob",(D),University of Pennsylvania,216298,0,216298
"Casey, Bob",(D),Comcast Corp,174063,40000,134063
"Casey, Bob",(D),Blank Rome LLP,169001,7500,161501
"Casey, Bob",(D),UPMC Health System,166903,0,166903
"Casey, Bob",(D),Exelon Corp,138231,16500,121731
"Casey, Bob",(D),"Kessler, Topaz et al",134552,0,134552
"Casey, Bob",(D),Air Products & Chemicals Inc,128335,20000,108335
"Casey, Bob",(D),University of Pittsburgh,120121,0,120121
"Casey, Bob",(D),Blue Cross/Blue Shield,113545,36000,77545
"Casey, Bob",(D),Reed Smith LLP,100635,10000,90635
"Casey, Bob",(D),Merck & Co,99768,34500,65268
"Casey, Bob",(D),"Buchanan, Ingersoll & Rooney",92522,7042,85480
"Casey, Bob",(D),Pride Mobility Products,84450,19000,65450
"Casey, Bob",(D),Cozen O'Connor,81750,19500,62250
"Casey, Bob",(D),League of Conservation Voters,81269,13996,67273
"Casey, Bob",(D),Ballard Spahr Llp,76153,1000,75153
"Casey, Bob",(D),Ross Feller Casey LLP,73325,0,73325
"Casey, Bob",(D),Rite Aid Corp,67025,9500,57525
"Casey, Bob",(D),Duane Morris LLP,65645,7400,58245
"Casey, Bob",(D),Commonwealth of Pennsylvania,63058,0,63058
"Casey, Bob",(D),"Edgar, Snyder & Assoc",62855,0,62855
"Casey, Bob",(D),Berger & Montague,62775,0,62775
"Casey, Bob",(D),Carlyle Group,61600,0,61600
"Casey, Bob",(D),"Akin, Gump et al",58256,5302,52954
"Casey, Bob",(D),K&L Gates,57250,7000,50250
"Casey, Bob",(D),Apollo Global Management,57158,4000,53158
"Casey, Bob",(D),Deloitte LLP,57004,35000,22004
"Casey, Bob",(D),Penn State University,55789,0,55789
"Casey, Bob",(D),University of Pennsylvania Health System,55576,5700,49876
"Casey, Bob",(D),Temple University,55432,0,55432
"Casey, Bob",(D),Sony Corp,55036,2500,52536
"Casey, Bob",(D),Morgan Lewis LLP,53275,0,53275
"Casey, Bob",(D),UBS AG,52500,35000,17500
"Casey, Bob",(D),Democracy Engine,52035,0,52035
"Casey, Bob",(D),United Food & Commercial Workers Union,51625,17000,34625
"Casey, Bob",(D),NorPAC,50640,0,50640
"Casey, Bob",(D),Boeing Co,50047,10000,40047
"Casey, Bob",(D),"Lieff, Cabraser et al",45840,0,45840
"Casey, Bob",(D),KPMG LLP,45750,40500,5250
"Casey, Bob",(D),Jefferson Health System,44710,0,44710
"Casey, Bob",(D),Eli Lilly & Co,43825,17000,26825
"Casey, Bob",(D),Grant & Eisenhofer,42800,0,42800
"Casey, Bob",(D),Laborers Union,42450,30000,12450
"Casey, Bob",(D),National Assn of Real Estate Investment Trusts,41500,37500,4000
"Casey, Bob",(D),Pepper Hamilton LLP,41415,3000,38415
"Casey, Bob",(D),Anapol Weiss,41400,0,41400
"Casey, Bob",(D),Geisinger Health Systems,41318,0,41318
"Casey, Bob",(D),"Goldberg, Persky & White",40850,0,40850
"Casey, Bob",(D),Dilworth Paxson LLP,40505,0,40505
"Casey, Bob",(D),Johnson & Johnson,40331,25500,14831
"Casey, Bob",(D),Dechert Llp,40160,0,40160
"Casey, Bob",(D),Capitol Counsel,40115,0,40115
"Casey, Bob",(D),Humana Inc,40025,40000,25
"Casey, Bob",(D),Brandywine Realty Trust,39850,0,39850
"Casey, Bob",(D),Amazon.com,39640,25000,14640
"Casey, Bob",(D),Day & Zimmermann,39338,8000,31338
"Casey, Bob",(D),Ernst & Young,39130,37500,1630
"Casey, Bob",(D),Pfizer Inc,38701,36000,2701
"Casey, Bob",(D),Honeywell International,38588,35000,3588
"Casey, Bob",(D),Toll Brothers Inc,38420,5000,33420
"Casey, Bob",(D),AT&T Inc,37902,10500,27402
"Casey, Bob",(D),Holt Logistics,37900,0,37900
"Casey, Bob",(D),Senior Care Pharmacy Coalition,37865,27500,10365
"Casey, Bob",(D),Lenahan & Dempsey,37863,0,37863
"Casey, Bob",(D),Fox Rothschild LLP,37769,4700,33069
"Casey, Bob",(D),Carnegie Mellon University,37528,0,37528
"Casey, Bob",(D),"Sheet Metal, Air, Rail & Transportation Union",37000,37000,0
"Casey, Bob",(D),American Assn for Justice,36750,35000,1750
"Casey, Bob",(D),Cigna Corp,36586,27500,9086
"Casey, Bob",(D),FS Investments,35900,10900,25000
"Casey, Bob",(D),"Eckert, Seamans et al",35775,0,35775
"Casey, Bob",(D),Cooney & Conway,35400,0,35400
"Casey, Bob",(D),Penn Medicine,35138,0,35138
"Casey, Bob",(D),Kirkland & Ellis,35120,0,35120
"Casey, Bob",(D),"Cohen, Placitella & Roth",35100,0,35100
"Casey, Bob",(D),Guardian Life Insurance,34410,5000,29410
"Casey, Bob",(D),PPL Corp,34359,16000,18359
"Casey, Bob",(D),Lehigh Valley Technologies,33600,0,33600
"Casey, Bob",(D),National Assn of Broadcasters,33500,13500,20000
"Casey, Bob",(D),Sullivan & Cromwell,33500,0,33500
"Casey, Bob",(D),Piasecki Aircraft,32600,0,32600
"Casey, Bob",(D),PricewaterhouseCoopers,32597,29000,3597
"Casey, Bob",(D),National Assn of Realtors,32500,32500,0
"Casey, Bob",(D),Select Medical Holdings,32500,22500,10000
"Casey, Bob",(D),Bad Robot Productions,32400,0,32400
"Casey, Bob",(D),DreamWorks SKG,32400,0,32400
"Casey, Bob",(D),Rudin Management,32400,0,32400
"Casey, Bob",(D),International Brotherhood of Electrical Workers,32358,31000,1358
"Casey, Bob",(D),Fidelity Investments,32100,14500,17600
"Casey, Bob",(D),Raynes McCarty,32015,0,32015
"Casey, Bob",(D),Children's Hospital of Philadelphia,31852,0,31852
"Casey, Bob",(D),Stevens & Lee,31850,0,31850
"Casey, Bob",(D),Novocure Inc,31800,13000,18800
"Casey, Bob",(D),"Myers, Brier & Kelly",31651,0,31651
"Casey, Bob",(D),Sutherland Capital Management,31600,0,31600
"Casey, Bob",(D),Air Line Pilots Assn,31500,31500,0
"Casey, Bob",(D),American Seniors Housing Assn,31500,31500,0
"Casey, Bob",(D),Nationwide,31425,10000,21425
"Casey, Bob",(D),IBM Corp,31325,0,31325
"Casey, Bob",(D),Drexel University,30936,0,30936
"Cassidy, Bill",(R),Ochsner Health System,122840,0,122840
"Cassidy, Bill",(R),Acadian Companies,91850,15000,76850
"Cassidy, Bill",(R),Edison Chouest Offshore,66400,0,66400
"Cassidy, Bill",(R),AbbVie Inc,62752,42500,20252
"Cassidy, Bill",(R),NorPAC,59200,0,59200
"Cassidy, Bill",(R),KKR & Co,57645,13000,44645
"Cassidy, Bill",(R),B&G Food Enterprises,56135,0,56135
"Cassidy, Bill",(R),Jones Walker LLP,52525,29500,23025
"Cassidy, Bill",(R),Amedisys Inc,50275,30000,20275
"Cassidy, Bill",(R),"Welsh, Carson et al",49700,0,49700
"Cassidy, Bill",(R),Neurological Surgery Pc,49600,0,49600
"Cassidy, Bill",(R),Morris & Dickson,47600,0,47600
"Cassidy, Bill",(R),Berkshire Hathaway,46225,9000,37225
"Cassidy, Bill",(R),UnitedHealth Group,46220,30000,16220
"Cassidy, Bill",(R),Clearpath Foundation,45398,0,45398
"Cassidy, Bill",(R),Bollinger Shipyards,45000,0,45000
"Cassidy, Bill",(R),National Republican Senatorial Cmte,44602,44600,2
"Cassidy, Bill",(R),Entergy Corp,44590,27000,17590
"Cassidy, Bill",(R),Adams & Reese,44250,33500,10750
"Cassidy, Bill",(R),Blackstone Group,43375,1000,42375
"Cassidy, Bill",(R),McNa Dental Plans,42300,0,42300
"Cassidy, Bill",(R),Wampold Companies,41950,0,41950
"Cassidy, Bill",(R),Fresenius Medical Care,40059,30000,10059
"Cassidy, Bill",(R),American College of Emergency Physicians,40000,40000,0
"Cassidy, Bill",(R),American Society of Interventional Pain Physicians,40000,40000,0
"Cassidy, Bill",(R),DaVita Inc,40000,34000,6000
"Cassidy, Bill",(R),Cajun Industries,38950,0,38950
"Cassidy, Bill",(R),Woodvine Group,37400,0,37400
"Cassidy, Bill",(R),American Academy of Dermatology Assn,36000,36000,0
"Cassidy, Bill",(R),Atco Investment,35100,0,35100
"Cassidy, Bill",(R),National Assn of Realtors,35000,35000,0
"Cassidy, Bill",(R),Roche Holdings,35000,30000,5000
"Cassidy, Bill",(R),Valero Energy,35000,32500,2500
"Cassidy, Bill",(R),Southern Brain & Spine,34300,0,34300
"Cassidy, Bill",(R),Honeywell International,34155,34000,155
"Cassidy, Bill",(R),Woodbranch Investments,32700,0,32700
"Cassidy, Bill",(R),United Parcel Service,32620,32500,120
"Cassidy, Bill",(R),American Society of Anesthesiologists,32500,32500,0
"Cassidy, Bill",(R),Amgen Inc,32500,32500,0
"Cassidy, Bill",(R),McKesson Corp,32500,25000,7500
"Cassidy, Bill",(R),Viemed,31875,0,31875
"Cassidy, Bill",(R),Civic Service Inc,31200,0,31200
"Cassidy, Bill",(R),Premier Inc,31025,7500,23525
"Cassidy, Bill",(R),1st Financial Bank USA,30800,0,30800
"Cassidy, Bill",(R),GBX Group,30500,0,30500
"Cassidy, Bill",(R),Arkansas Urology,30000,0,30000
"Cassidy, Bill",(R),Charter Communications,30000,30000,0
"Cassidy, Bill",(R),Union Pacific Corp,30000,30000,0
"Cassidy, Bill",(R),Northrop Grumman,29765,29500,265
"Cassidy, Bill",(R),Matilda Stream Management,29500,0,29500
"Cassidy, Bill",(R),Centene Corp,28650,14500,14150
"Cassidy, Bill",(R),Citizens for Prosperity in America Today,28650,10000,18650
"Cassidy, Bill",(R),Humana Inc,28580,28500,80
"Cassidy, Bill",(R),Tellurian Inc,28500,6000,22500
"Cassidy, Bill",(R),Woodlawn Investments,28200,0,28200
"Cassidy, Bill",(R),Pfizer Inc,26575,24500,2075
"Cassidy, Bill",(R),American Assn of Orthopaedic Surgeons,26500,26500,0
"Cassidy, Bill",(R),Corporate Capital LLC,26400,0,26400
"Cassidy, Bill",(R),American Hospital Assn,26000,26000,0
"Cassidy, Bill",(R),Magnolia Marketing,25800,0,25800
"Cassidy, Bill",(R),American Academy of Ophthalmology,25500,25500,0
"Cassidy, Bill",(R),American College of Radiology,25500,25500,0
"Cassidy, Bill",(R),Franks Petroleum,25400,0,25400
"Cassidy, Bill",(R),ISC Constructors,25200,0,25200
"Cassidy, Bill",(R),Cigna Corp,25060,25000,60
"Cassidy, Bill",(R),New York Life Insurance,25025,25000,25
"Cassidy, Bill",(R),Altria Group,25010,25000,10
"Cassidy, Bill",(R),Deloitte LLP,25010,25000,10
"Cassidy, Bill",(R),American Optometric Assn,25000,24000,1000
"Cassidy, Bill",(R),National Assn of Real Estate Investment Trusts,25000,25000,0
"Cassidy, Bill",(R),American Assn of Neurological Surgeons,24500,24500,0
"Cassidy, Bill",(R),American Psychiatric Assn,24500,24500,0
"Cassidy, Bill",(R),Lumen Technologies,24145,21000,3145
"Cassidy, Bill",(R),BGR Group,24000,1500,22500
"Cassidy, Bill",(R),Performance Contractors Inc,23900,0,23900
"Cassidy, Bill",(R),Blue Cross/Blue Shield,23035,19500,3535
"Cassidy, Bill",(R),Republic Finance,22600,0,22600
"Cassidy, Bill",(R),American Medical Assn,22575,22500,75
"Cassidy, Bill",(R),National Beer Wholesalers Assn,22500,22500,0
"Cassidy, Bill",(R),Metro Aviation Inc,22425,0,22425
"Cassidy, Bill",(R),Johnson & Johnson,22300,19500,2800
"Cassidy, Bill",(R),American College of Cardiology,22000,22000,0
"Cassidy, Bill",(R),Harvey Gulf International Marine,21800,0,21800
"Cassidy, Bill",(R),Hercules Transport,21800,0,21800
"Cassidy, Bill",(R),Madden Contracting,21600,0,21600
"Cassidy, Bill",(R),Sher Garner Law Firm,21600,0,21600
"Cassidy, Bill",(R),Phi Inc,21210,0,21210
"Cassidy, Bill",(R),American Academy of Family Physicians,21000,20000,1000
"Cassidy, Bill",(R),Cox Enterprises,21000,16000,5000
"Cassidy, Bill",(R),Picard Group,20900,0,20900
"Cassidy, Bill",(R),Greater New York Hospital Assn,20800,0,20800
"Cassidy, Bill",(R),Laitram Llc,20800,0,20800
"Cassidy, Bill",(R),Murphy Oil,20800,7500,13300
"Cassidy, Bill",(R),Enterprise Holdings,20600,15000,5600
"Cassidy, Bill",(R),Vertex Pharmaceuticals,20600,11500,9100
"Cassidy, Bill",(R),Stonehenge Capital Co,20544,0,20544
"Cassidy, Bill",(R),Comcast Corp,20500,20500,0
"Cassidy, Bill",(R),American Chemistry Council,20000,19500,500
"Cassidy, Bill",(R),American Dental Assn,20000,20000,0
"Cassidy, Bill",(R),Dan Shapiro,20000,0,20000
"Collins, Susan",(R),Votesane PAC,117575,0,117575
"Collins, Susan",(R),Blackstone Group,87821,0,87821
"Collins, Susan",(R),General Dynamics,72103,35000,37103
"Collins, Susan",(R),FedEx Corp,64860,39000,25860
"Collins, Susan",(R),Blue Cross/Blue Shield,63711,34500,29211
"Collins, Susan",(R),Republican Jewish Coalition,62067,5000,57067
"Collins, Susan",(R),Goldman Sachs,52175,5000,47175
"Collins, Susan",(R),National Assn of Broadcasters,49500,19500,30000
"Collins, Susan",(R),Lockheed Martin,49382,40000,9382
"Collins, Susan",(R),Northrop Grumman,44755,35000,9755
"Collins, Susan",(R),National Republican Senatorial Cmte,44649,44600,49
"Collins, Susan",(R),Elliott Management,44000,0,44000
"Collins, Susan",(R),KKR & Co,43148,5000,38148
"Collins, Susan",(R),Honeywell International,42260,40000,2260
"Collins, Susan",(R),Deloitte LLP,41333,40000,1333
"Collins, Susan",(R),Union Pacific Corp,40333,37500,2833
"Collins, Susan",(R),Mortgage Bankers Assn,40000,40000,0
"Collins, Susan",(R),Sullivan & Cromwell,39848,0,39848
"Collins, Susan",(R),"Gibson, Dunn & Crutcher",37881,6250,31631
"Collins, Susan",(R),International Paper,37845,35000,2845
"Collins, Susan",(R),Charter Communications,37425,25000,12425
"Collins, Susan",(R),"Welsh, Carson et al",36200,0,36200
"Collins, Susan",(R),Raytheon Technologies,35822,21000,14822
"Collins, Susan",(R),McNa Dental Plans,35600,0,35600
"Collins, Susan",(R),American Seniors Housing Assn,35000,35000,0
"Collins, Susan",(R),National Multifamily Housing Council,35000,35000,0
"Collins, Susan",(R),Berkshire Hathaway,34523,31000,3523
"Collins, Susan",(R),American Dental Assn,32500,32500,0
"Collins, Susan",(R),Massachusetts Mutual Life Insurance,31675,31500,175
"Collins, Susan",(R),Unum Group,31365,20000,11365
"Collins, Susan",(R),Hunt Consolidated,30200,0,30200
"Collins, Susan",(R),Automotive Free International Trade PAC,30000,30000,0
"Collins, Susan",(R),Senior Star,29900,0,29900
"Collins, Susan",(R),Comcast Corp,28841,22500,6341
"Collins, Susan",(R),Stephens Inc,28700,5000,23700
"Collins, Susan",(R),Corning Inc,28395,28000,395
"Collins, Susan",(R),NorPAC,27850,0,27850
"Collins, Susan",(R),Huntington Ingalls Industries,27546,25000,2546
"Collins, Susan",(R),National Assn of Home Builders,27500,27500,0
"Collins, Susan",(R),American Hotel & Lodging Assn,26000,26000,0
"Collins, Susan",(R),BAE Systems,25838,25000,838
"Collins, Susan",(R),Morgan Stanley,25133,7500,17633
"Collins, Susan",(R),Argentum,25000,25000,0
"Collins, Susan",(R),Home Depot,24868,20000,4868
"Collins, Susan",(R),Yancey Brothers,24000,0,24000
"Collins, Susan",(R),Abbott Laboratories,23986,23000,986
"Collins, Susan",(R),Ernst & Young,23940,20000,3940
"Collins, Susan",(R),Anthem Inc,23405,18500,4905
"Collins, Susan",(R),Kirkland & Ellis,23400,0,23400
"Collins, Susan",(R),RTX Corp,23232,21500,1732
"Collins, Susan",(R),Neuberger Berman LLC,22800,0,22800
"Collins, Susan",(R),American Hospital Assn,22750,18500,4250
"Collins, Susan",(R),United Parcel Service,22563,20000,2563
"Collins, Susan",(R),American College of Emergency Physicians,22500,22500,0
"Collins, Susan",(R),Amscot Financial,22400,0,22400
"Collins, Susan",(R),Ashley Furniture,22400,0,22400
"Collins, Susan",(R),Pilot Corp,22400,0,22400
"Collins, Susan",(R),Air Line Pilots Assn,22000,22000,0
"Collins, Susan",(R),American Trucking Assns,22000,20000,2000
"Collins, Susan",(R),Affiliated Managers Group,21800,0,21800
"Collins, Susan",(R),Beztak Companies,21800,0,21800
"Collins, Susan",(R),Centene Corp,21699,16000,5699
"Collins, Susan",(R),Bank of America,21534,11000,10534
"Collins, Susan",(R),Cohen Group,21400,0,21400
"Collins, Susan",(R),Pinnacle West Capital,21375,10000,11375
"Collins, Susan",(R),New Balance Athletics,21350,0,21350
"Collins, Susan",(R),Experian,21300,10000,11300
"Collins, Susan",(R),Kasowitz Benson Torres LLP,21300,0,21300
"Collins, Susan",(R),Humana Inc,21258,21000,258
"Collins, Susan",(R),Clearpath Foundation,21200,0,21200
"Collins, Susan",(R),Great Point Partners,21200,0,21200
"Collins, Susan",(R),TGS Management,21200,0,21200
"Collins, Susan",(R),Tuttle-Click Automotive Group,21200,0,21200
"Collins, Susan",(R),American Bankers Assn,21000,20000,1000
"Collins, Susan",(R),American Physical Therapy Assn,21000,21000,0
"Collins, Susan",(R),Bernard Marcus Family Foundation,20800,0,20800
"Collins, Susan",(R),Indigo Partners,20800,0,20800
"Collins, Susan",(R),Leach Capital,20800,0,20800
"Collins, Susan",(R),Oberndorf Enterprises,20800,0,20800
"Collins, Susan",(R),Encompass Health,20730,10000,10730
"Collins, Susan",(R),GoldenTree Asset Management,20600,0,20600
"Collins, Susan",(R),General Motors,20554,19000,1554
"Collins, Susan",(R),PricewaterhouseCoopers,20518,15000,5518
"Collins, Susan",(R),Kirby Corp,20500,7500,13000
"Collins, Susan",(R),American Property Casualty Insurance Assn,20200,17500,2700
"Collins, Susan",(R),Holland & Knight,20025,8500,11525
"Collins, Susan",(R),National Assn of Realtors,20025,20000,25
"Collins, Susan",(R),Penske Corp,19950,0,19950
"Collins, Susan",(R),American Council of Life Insurers,19600,10000,9600
"Collins, Susan",(R),Walmart Inc,19360,16000,3360
"Collins, Susan",(R),Van Scoyoc Assoc,18600,0,18600
"Collins, Susan",(R),Facebook Inc,18598,7000,11598
"Collins, Susan",(R),Genworth Financial,18450,8000,10450
"Collins, Susan",(R),Allen & Co,18400,0,18400
"Collins, Susan",(R),Renaissance Technologies,18300,0,18300
"Collins, Susan",(R),Moore Capital Management,18200,0,18200
"Collins, Susan",(R),Delta Air Lines,18197,13500,4697
"Collins, Susan",(R),National Air Traffic Controllers Assn,18000,18000,0
"Collins, Susan",(R),General Electric,17995,16000,1995
"Collins, Susan",(R),Enterprise Holdings,17915,15000,2915
"Coons, Chris",(D),"Young, Conaway et al",103725,0,103725
"Coons, Chris",(D),Apollo Global Management,79605,0,79605
"Coons, Chris",(D),Amgen Inc,78500,40000,38500
"Coons, Chris",(D),InterDigital Inc,72812,39800,33012
"Coons, Chris",(D),Comcast Corp,61014,40000,21014
"Coons, Chris",(D),Microsoft Corp,57728,40000,17728
"Coons, Chris",(D),Jane Street Capital,54100,0,54100
"Coons, Chris",(D),Goldman Sachs,50100,35000,15100
"Coons, Chris",(D),Merck & Co,46125,40000,6125
"Coons, Chris",(D),Pfizer Inc,45055,40000,5055
"Coons, Chris",(D),WL Gore & Assoc,43108,0,43108
"Coons, Chris",(D),National Assn of Broadcasters,42750,37500,5250
"Coons, Chris",(D),DuPont Co,42152,11500,30652
"Coons, Chris",(D),Bristol-Myers Squibb,42025,39500,2525
"Coons, Chris",(D),Blue Cross/Blue Shield,40745,38000,2745
"Coons, Chris",(D),United Parcel Service,40458,40000,458
"Coons, Chris",(D),AbbVie Inc,40005,40000,5
"Coons, Chris",(D),Sallie Mae,40000,40000,0
"Coons, Chris",(D),Wirtz Corp,38000,0,38000
"Coons, Chris",(D),Honeywell International,37502,37500,2
"Coons, Chris",(D),Norfolk Southern,37500,37500,0
"Coons, Chris",(D),AT&T Inc,36658,26000,10658
"Coons, Chris",(D),"Paul, Weiss et al",36600,0,36600
"Coons, Chris",(D),Google Inc,36521,24500,12021
"Coons, Chris",(D),JPMorgan Chase & Co,36343,27500,8843
"Coons, Chris",(D),Bank of America,35255,32000,3255
"Coons, Chris",(D),UBS AG,35045,35000,45
"Coons, Chris",(D),Mortgage Bankers Assn,35000,35000,0
"Coons, Chris",(D),National Chicken Council,35000,35000,0
"Coons, Chris",(D),NCTA The Internet & Television Assn,35000,35000,0
"Coons, Chris",(D),Intellectual Ventures LLC,34500,29500,5000
"Coons, Chris",(D),Capital Group Companies,33800,22500,11300
"Coons, Chris",(D),Deloitte LLP,33653,32500,1153
"Coons, Chris",(D),DISH Network,33500,20500,13000
"Coons, Chris",(D),AstraZeneca PLC,33140,32500,640
"Coons, Chris",(D),American Bankers Assn,32750,32500,250
"Coons, Chris",(D),Charter Communications,32500,32500,0
"Coons, Chris",(D),CSX Corp,32500,32500,0
"Coons, Chris",(D),Lockheed Martin,32000,31000,1000
"Coons, Chris",(D),Democracy Engine,31500,0,31500
"Coons, Chris",(D),Ernst & Young,31050,30000,1050
"Coons, Chris",(D),Cigna Corp,30068,30000,68
"Coons, Chris",(D),American Assn for Justice,30025,30000,25
"Coons, Chris",(D),American Hotel & Lodging Assn,30000,30000,0
"Coons, Chris",(D),National Rural Electric Cooperative Assn,30000,30000,0
"Coons, Chris",(D),Union Pacific Corp,30000,30000,0
"Coons, Chris",(D),K&L Gates,29805,8000,21805
"Coons, Chris",(D),Walt Disney Co,28725,13000,15725
"Coons, Chris",(D),Bill & Melinda Gates Foundation,28300,0,28300
"Coons, Chris",(D),Centerview Partners,28000,0,28000
"Coons, Chris",(D),National Assn of Realtors,27508,25000,2508
"Coons, Chris",(D),Qualcomm Inc,27400,16000,11400
"Coons, Chris",(D),Covington & Burling,27350,20000,7350
"Coons, Chris",(D),TD Bank USA,27210,12000,15210
"Coons, Chris",(D),Biogen,26000,18500,7500
"Coons, Chris",(D),"Akin, Gump et al",25850,2750,23100
"Coons, Chris",(D),Weiss Asset Management,25800,0,25800
"Coons, Chris",(D),alliantgroup,25200,0,25200
"Coons, Chris",(D),Berkshire Hathaway,25109,24000,1109
"Coons, Chris",(D),Discover Financial Services,24600,10000,14600
"Coons, Chris",(D),Grant & Eisenhofer,24000,0,24000
"Coons, Chris",(D),Bergman Draper Oslund,23300,0,23300
"Coons, Chris",(D),PricewaterhouseCoopers,23030,22500,530
"Coons, Chris",(D),Target Corp,23008,23000,8
"Coons, Chris",(D),Roche Holdings,23000,20000,3000
"Coons, Chris",(D),BASF Corp,22568,22500,68
"Coons, Chris",(D),"Morris, Nichols et al",22505,0,22505
"Coons, Chris",(D),National Beer Wholesalers Assn,22500,22500,0
"Coons, Chris",(D),Wine & Spirits Wholesalers of America,22500,22500,0
"Coons, Chris",(D),Sanofi US,22300,19500,2800
"Coons, Chris",(D),National Confectioners Assn,22000,22000,0
"Coons, Chris",(D),AFLAC Inc,21600,16000,5600
"Coons, Chris",(D),New York Life Insurance,21513,21500,13
"Coons, Chris",(D),Navient Corp,21500,16000,5500
"Coons, Chris",(D),Wonderful Co,21200,0,21200
"Coons, Chris",(D),Gfp Real Estate,21100,0,21100
"Coons, Chris",(D),Laborers Union,21000,20000,1000
"Coons, Chris",(D),Blackstone Group,20901,0,20901
"Coons, Chris",(D),Barclays,20805,10000,10805
"Coons, Chris",(D),Highfields Capital Management,20800,0,20800
"Coons, Chris",(D),Lauder Partners,20800,0,20800
"Coons, Chris",(D),Citigroup Inc,20630,16500,4130
"Coons, Chris",(D),Verizon Communications,20583,20000,583
"Coons, Chris",(D),Independent Community Bankers of America,20500,20500,0
"Coons, Chris",(D),"Brownstein, Hyatt et al",20100,6000,14100
"Coons, Chris",(D),American Seniors Housing Assn,20000,20000,0
"Coons, Chris",(D),National Assn of Letter Carriers,20000,20000,0
"Coons, Chris",(D),National Multifamily Housing Council,20000,20000,0
"Coons, Chris",(D),National Venture Capital Assn,20000,20000,0
"Coons, Chris",(D),Sullivan & Cromwell,19800,0,19800
"Coons, Chris",(D),"Kleiner, Perkins et al",19400,0,19400
"Coons, Chris",(D),Lpt Partners LLC,19400,0,19400
"Coons, Chris",(D),Buccini/Pollin Group,19000,0,19000
"Coons, Chris",(D),National Air Traffic Controllers Assn,19000,19000,0
"Coons, Chris",(D),USAA,19000,17500,1500
"Coons, Chris",(D),Visa Inc,19000,18500,500
"Coons, Chris",(D),Condo Roccia Koptiw Llp,18500,0,18500
"Coons, Chris",(D),Alston & Bird,18000,13500,4500
"Coons, Chris",(D),American Institute of CPAs,18000,18000,0
"Coons, Chris",(D),Data & Marketing Assn,18000,6000,12000
"Cornyn, John",(R),Apollo Global Management,200695,8000,192695
"Cornyn, John",(R),KKR & Co,131540,8500,123040
"Cornyn, John",(R),Berkshire Hathaway,119326,40000,79326
"Cornyn, John",(R),Blue Cross/Blue Shield,91380,75500,15880
"Cornyn, John",(R),Dell Technologies,89786,31000,58786
"Cornyn, John",(R),"Paul, Weiss et al",84200,0,84200
"Cornyn, John",(R),Fidelity Investments,78375,40000,38375
"Cornyn, John",(R),Blackstone Group,76780,0,76780
"Cornyn, John",(R),Occidental Petroleum,74254,37500,36754
"Cornyn, John",(R),Marathon Petroleum,71913,52500,19413
"Cornyn, John",(R),Bobby Cox Companies,68615,0,68615
"Cornyn, John",(R),Fresenius Medical Care,68129,25000,43129
"Cornyn, John",(R),Energy Transfer LP,65695,10000,55695
"Cornyn, John",(R),UBS AG,64350,40000,24350
"Cornyn, John",(R),iHeartMedia Inc,63825,27500,36325
"Cornyn, John",(R),Hunt Consolidated,63787,0,63787
"Cornyn, John",(R),"Akin, Gump et al",63699,25937,37762
"Cornyn, John",(R),Lockheed Martin,58929,40000,18929
"Cornyn, John",(R),Chevron Corp,58352,12500,45852
"Cornyn, John",(R),Microsoft Corp,58288,32500,25788
"Cornyn, John",(R),United Airlines Holdings,54781,10000,44781
"Cornyn, John",(R),General Atomics,53550,25000,28550
"Cornyn, John",(R),USAA,52888,40000,12888
"Cornyn, John",(R),AT&T Inc,52027,38000,14027
"Cornyn, John",(R),GEO Group,51600,13000,38600
"Cornyn, John",(R),Northrop Grumman,51184,49000,2184
"Cornyn, John",(R),JPMorgan Chase & Co,50975,24500,26475
"Cornyn, John",(R),Prudential Financial,50000,50000,0
"Cornyn, John",(R),Lanier Law Firm,49800,0,49800
"Cornyn, John",(R),Sewell Automotive,49750,0,49750
"Cornyn, John",(R),Goldman Sachs,49725,30000,19725
"Cornyn, John",(R),Altria Group,49399,40000,9399
"Cornyn, John",(R),Eli Lilly & Co,48003,35000,13003
"Cornyn, John",(R),NextEra Energy,47376,22500,24876
"Cornyn, John",(R),Hewlett Packard Enterprise,47069,41000,6069
"Cornyn, John",(R),United Parcel Service,47025,40000,7025
"Cornyn, John",(R),Capital Group Companies,46773,25000,21773
"Cornyn, John",(R),Hunt Companies,46725,0,46725
"Cornyn, John",(R),State of Texas,45531,0,45531
"Cornyn, John",(R),Merck & Co,45110,40000,5110
"Cornyn, John",(R),Station Casinos,45000,0,45000
"Cornyn, John",(R),American Bankers Assn,44675,37500,7175
"Cornyn, John",(R),National Republican Senatorial Cmte,44630,44600,30
"Cornyn, John",(R),UnitedHealth Group,44395,32500,11895
"Cornyn, John",(R),Kirby Corp,43800,21500,22300
"Cornyn, John",(R),TPG Capital,43700,0,43700
"Cornyn, John",(R),Pfizer Inc,43085,31500,11585
"Cornyn, John",(R),Mortgage Bankers Assn,42800,40000,2800
"Cornyn, John",(R),Verizon Communications,42728,37000,5728
"Cornyn, John",(R),CVS Health,42701,40000,2701
"Cornyn, John",(R),Deloitte LLP,42558,39500,3058
"Cornyn, John",(R),National Assn of Home Builders,41750,40000,1750
"Cornyn, John",(R),National Assn of Realtors,41525,40000,1525
"Cornyn, John",(R),Ernst & Young,41450,30000,11450
"Cornyn, John",(R),Comcast Corp,41443,40000,1443
"Cornyn, John",(R),Walmart Inc,41082,31000,10082
"Cornyn, John",(R),Union Pacific Corp,40701,40000,701
"Cornyn, John",(R),Ryan LLC,40200,15000,25200
"Cornyn, John",(R),International Paper,40175,40000,175
"Cornyn, John",(R),American Hotel & Lodging Assn,40000,40000,0
"Cornyn, John",(R),Automotive Free International Trade PAC,40000,40000,0
"Cornyn, John",(R),National Auto Dealers Assn,40000,40000,0
"Cornyn, John",(R),National Multifamily Housing Council,40000,40000,0
"Cornyn, John",(R),Southwest Airlines,39838,11500,28338
"Cornyn, John",(R),Citizens for Prosperity in America Today,39600,5000,34600
"Cornyn, John",(R),National Assn of Broadcasters,39500,35000,4500
"Cornyn, John",(R),Walter Oil & Gas,39400,0,39400
"Cornyn, John",(R),Zachry Holdings,39300,10000,29300
"Cornyn, John",(R),Visa Inc,39060,18000,21060
"Cornyn, John",(R),Honeywell International,39006,35500,3506
"Cornyn, John",(R),Mary Kay Inc,38820,0,38820
"Cornyn, John",(R),Bluff Point Assoc,38800,0,38800
"Cornyn, John",(R),Abbott Laboratories,38750,38000,750
"Cornyn, John",(R),Amgen Inc,38450,24000,14450
"Cornyn, John",(R),Kindred Healthcare,38250,22500,15750
"Cornyn, John",(R),"Welsh, Carson et al",37800,0,37800
"Cornyn, John",(R),American Institute of CPAs,37500,37500,0
"Cornyn, John",(R),Wine & Spirits Wholesalers of America,37500,37500,0
"Cornyn, John",(R),Home Depot,37460,35000,2460
"Cornyn, John",(R),Sempra Energy,37275,25000,12275
"Cornyn, John",(R),National Assn of Real Estate Investment Trusts,36500,35000,1500
"Cornyn, John",(R),Humana Inc,36484,35000,1484
"Cornyn, John",(R),Pediatrix Medical Group,36350,20000,16350
"Cornyn, John",(R),Clearpath Foundation,36200,0,36200
"Cornyn, John",(R),FedEx Corp,36193,35000,1193
"Cornyn, John",(R),Alphabet Inc,35305,35000,305
"Cornyn, John",(R),PNC Financial Services,35055,35000,55
"Cornyn, John",(R),American Dental Assn,35000,35000,0
"Cornyn, John",(R),Investment Co Institute,35000,35000,0
"Cornyn, John",(R),NCTA The Internet & Television Assn,35000,35000,0
"Cornyn, John",(R),Sanofi US,35000,30000,5000
"Cornyn, John",(R),Norton Rose Fulbright LLP,34819,8500,26319
"Cornyn, John",(R),Harbinger Strategies,34800,0,34800
"Cornyn, John",(R),Greenberg Traurig Llp,34500,15000,19500
"Cornyn, John",(R),S&B Engineers & Constructors,34150,5000,29150
"Cornyn, John",(R),Reyes Holdings,33900,0,33900
"Cornyn, John",(R),Kleinheinz Capital Partners,33800,0,33800
"Cornyn, John",(R),McKesson Corp,33698,30000,3698
"Cornyn, John",(R),Cavalry Asset Management,33600,0,33600
"Cornyn, John",(R),Duty Free Americas,33600,0,33600
"Cotton, Tom",(R),Goldman Sachs,182100,25000,157100
"Cotton, Tom",(R),McNa Dental Plans,95400,0,95400
"Cotton, Tom",(R),Stephens Inc,89600,5000,84600
"Cotton, Tom",(R),Lockheed Martin,77301,34000,43301
"Cotton, Tom",(R),Mountaire Corp,56000,0,56000
"Cotton, Tom",(R),Apollo Global Management,49070,0,49070
"Cotton, Tom",(R),Walmart Inc,45336,28500,16836
"Cotton, Tom",(R),Capital Group Companies,43600,5000,38600
"Cotton, Tom",(R),UBS AG,43075,40000,3075
"Cotton, Tom",(R),New York Life Insurance,42975,22000,20975
"Cotton, Tom",(R),Experian,39500,37000,2500
"Cotton, Tom",(R),Boston Consulting Group,38550,0,38550
"Cotton, Tom",(R),Cooper & Kirk,36900,0,36900
"Cotton, Tom",(R),Bank of America,36455,25000,11455
"Cotton, Tom",(R),Northrop Grumman,36367,35000,1367
"Cotton, Tom",(R),JW Childs Assoc,36200,0,36200
"Cotton, Tom",(R),American Bankers Assn,35550,35000,550
"Cotton, Tom",(R),Honeywell International,35491,30000,5491
"Cotton, Tom",(R),Mortgage Bankers Assn,35000,35000,0
"Cotton, Tom",(R),Pro-israel America PAC,33550,0,33550
"Cotton, Tom",(R),National Assn of Mutual Insurance Companies,32500,32500,0
"Cotton, Tom",(R),Dobbs Brothers Management,31200,0,31200
"Cotton, Tom",(R),Invemed Assoc,31200,0,31200
"Cotton, Tom",(R),UnitedHealth Group,30883,25000,5883
"Cotton, Tom",(R),"Gibson, Dunn & Crutcher",30650,0,30650
"Cotton, Tom",(R),Gerson Lehrman Group,30200,0,30200
"Cotton, Tom",(R),American Institute of CPAs,30000,30000,0
"Cotton, Tom",(R),Crossland Construction,30000,0,30000
"Cotton, Tom",(R),General Dynamics,29660,29500,160
"Cotton, Tom",(R),United Parcel Service,28746,27500,1246
"Cotton, Tom",(R),PNC Financial Services,27530,17000,10530
"Cotton, Tom",(R),Affiliated Managers Group,27100,0,27100
"Cotton, Tom",(R),Independent Insurance Agents & Brokers of America,26500,26500,0
"Cotton, Tom",(R),Kent Companies,26200,0,26200
"Cotton, Tom",(R),Probity International,26000,0,26000
"Cotton, Tom",(R),Home Bancshares,25800,0,25800
"Cotton, Tom",(R),Read Investments,25800,0,25800
"Cotton, Tom",(R),Murphy Oil,25675,10000,15675
"Cotton, Tom",(R),Ernst & Young,25625,22500,3125
"Cotton, Tom",(R),Equity Group Investments,25600,0,25600
"Cotton, Tom",(R),Berkshire Hathaway,25571,23500,2071
"Cotton, Tom",(R),Union Pacific Corp,25025,25000,25
"Cotton, Tom",(R),Automotive Free International Trade PAC,25000,25000,0
"Cotton, Tom",(R),Independent Community Bankers of America,25000,25000,0
"Cotton, Tom",(R),Medstar Georgetown University Hospital,25000,0,25000
"Cotton, Tom",(R),Cordary Inc,24600,0,24600
"Cotton, Tom",(R),Unity Health (Arkansas),24600,0,24600
"Cotton, Tom",(R),"Simpson, Thacher & Bartlett",24500,0,24500
"Cotton, Tom",(R),NorPAC,24300,0,24300
"Cotton, Tom",(R),Wells Fargo,24279,12500,11779
"Cotton, Tom",(R),Blackstone Group,23913,0,23913
"Cotton, Tom",(R),State of Arkansas,23758,0,23758
"Cotton, Tom",(R),AT&T Inc,23699,20000,3699
"Cotton, Tom",(R),Massachusetts Mutual Life Insurance,23500,23500,0
"Cotton, Tom",(R),Cactus Wellhead,23400,0,23400
"Cotton, Tom",(R),Legado Companies,23200,0,23200
"Cotton, Tom",(R),Keil & Goodson,22700,0,22700
"Cotton, Tom",(R),Deloitte LLP,22666,22500,166
"Cotton, Tom",(R),Reyes Holdings,22400,0,22400
"Cotton, Tom",(R),Delphi Ventures,21800,0,21800
"Cotton, Tom",(R),Westrock Capital Partners,21625,0,21625
"Cotton, Tom",(R),"Welsh, Carson et al",21600,0,21600
"Cotton, Tom",(R),PricewaterhouseCoopers,21523,17500,4023
"Cotton, Tom",(R),Arbiter Partners,21200,0,21200
"Cotton, Tom",(R),Dyke Industries,21200,0,21200
"Cotton, Tom",(R),Fairholme Capital Management,21200,0,21200
"Cotton, Tom",(R),Route One Investment,21200,0,21200
"Cotton, Tom",(R),Crow Holdings,21000,0,21000
"Cotton, Tom",(R),Ariel Corp,20800,0,20800
"Cotton, Tom",(R),Buckley Muething Capital Management,20800,0,20800
"Cotton, Tom",(R),Highlander Partners,20800,0,20800
"Cotton, Tom",(R),Oaklawn Jockey Club,20800,0,20800
"Cotton, Tom",(R),Ocean Express Seafood,20800,0,20800
"Cotton, Tom",(R),Renaissance Technologies,20800,0,20800
"Cotton, Tom",(R),Lieblong & Assoc,20600,0,20600
"Cotton, Tom",(R),Access Industries,20400,0,20400
"Cotton, Tom",(R),Bluewater International,20400,0,20400
"Cotton, Tom",(R),Compass Point Group,20400,0,20400
"Cotton, Tom",(R),Greenhill & Co,20400,0,20400
"Cotton, Tom",(R),Comcast Corp,20335,20000,335
"Cotton, Tom",(R),"Cohen, Klingenstein & Marks",20200,0,20200
"Cotton, Tom",(R),Crescent Capital Group,20000,0,20000
"Cotton, Tom",(R),EXL Petroleum,20000,0,20000
"Cotton, Tom",(R),Paulson & Co,20000,0,20000
"Cotton, Tom",(R),Regions Financial,20000,20000,0
"Cotton, Tom",(R),"Paul, Weiss et al",19225,0,19225
"Cotton, Tom",(R),Citigroup Inc,19150,12500,6650
"Cotton, Tom",(R),Milbank LLP,18525,0,18525
"Cotton, Tom",(R),Simmons First National Bank,18500,0,18500
"Cotton, Tom",(R),Townsquare Media,18500,0,18500
"Cotton, Tom",(R),Hilton Worldwide,18232,7500,10732
"Cotton, Tom",(R),Investment Co Institute,18000,18000,0
"Cotton, Tom",(R),Village Properties,17900,0,17900
"Cotton, Tom",(R),Elliott Management,17800,0,17800
"Cotton, Tom",(R),USAA,17576,17500,76
"Cotton, Tom",(R),First Command Financial Services,17500,15000,2500
"Cotton, Tom",(R),Pine Bluff Sand & Gravel,17500,0,17500
"Cotton, Tom",(R),Blessey Marine Service,17400,5000,12400
"Cotton, Tom",(R),McKinsey & Co,16900,0,16900
"Cotton, Tom",(R),Amway/Alticor Inc,16800,0,16800
"Cramer, Kevin",(R),Energy Transfer LP,72800,0,72800
"Cramer, Kevin",(R),National Republican Senatorial Cmte,47400,47400,0
"Cramer, Kevin",(R),Ellingson Companies,44850,0,44850
"Cramer, Kevin",(R),Yancey Brothers,32400,0,32400
"Cramer, Kevin",(R),Alliance Coal,32166,10000,22166
"Cramer, Kevin",(R),Chord Energy,31850,5000,26850
"Cramer, Kevin",(R),DaVita Inc,29200,11500,17700
"Cramer, Kevin",(R),State of North Dakota,28050,0,28050
"Cramer, Kevin",(R),Blackstone Group,27000,0,27000
"Cramer, Kevin",(R),Marathon Oil,26500,7500,19000
"Cramer, Kevin",(R),Jennmar Corp,23500,0,23500
"Cramer, Kevin",(R),Alticor Inc,21600,0,21600
"Cramer, Kevin",(R),General Atomics,20900,15500,5400
"Cramer, Kevin",(R),Select Energy Services,20550,0,20550
"Cramer, Kevin",(R),MBI Energy Services,19900,0,19900
"Cramer, Kevin",(R),Kerian Machines,19600,0,19600
"Cramer, Kevin",(R),Council of Insurance Agents & Brokers,19000,19000,0
"Cramer, Kevin",(R),Tharaldson Hospitality,19000,0,19000
"Cramer, Kevin",(R),Republican National Cmte,18900,18900,0
"Cramer, Kevin",(R),Clearpath Foundation,18100,0,18100
"Cramer, Kevin",(R),Devon Energy,18100,10000,8100
"Cramer, Kevin",(R),University of North Dakota,17700,0,17700
"Cramer, Kevin",(R),Republican Jewish Coalition,17600,10000,7600
"Cramer, Kevin",(R),Marathon Petroleum,17500,17500,0
"Cramer, Kevin",(R),Fresenius Medical Care,17000,16000,1000
"Cramer, Kevin",(R),UBS Americas,17000,15000,2000
"Cramer, Kevin",(R),Cardon Global,16200,0,16200
"Cramer, Kevin",(R),Freeman Spogli & Co,16200,0,16200
"Cramer, Kevin",(R),TCW Group,16200,0,16200
"Cramer, Kevin",(R),International Franchise Assn,15000,10000,5000
"Cramer, Kevin",(R),Pilot Corp,13500,0,13500
"Cramer, Kevin",(R),Strata Corp,13500,0,13500
"Cramer, Kevin",(R),Tuttle-Click Automotive Group,13500,0,13500
"Cramer, Kevin",(R),Petro-Hunt LLC,13450,0,13450
"Cramer, Kevin",(R),NACCO Industries,13250,5000,8250
"Cramer, Kevin",(R),Community Oncology Alliance,13000,13000,0
"Cramer, Kevin",(R),Permian Enterprises,12883,0,12883
"Cramer, Kevin",(R),Brandt Holdings,12800,0,12800
"Cramer, Kevin",(R),TTT Ranch,12800,0,12800
"Cramer, Kevin",(R),National Electrical Contractors Assn,12500,12500,0
"Cramer, Kevin",(R),Odney Advertising,12250,0,12250
"Cramer, Kevin",(R),Berkshire Hathaway,12050,7500,4550
"Cramer, Kevin",(R),AT&T Inc,12005,12000,5
"Cramer, Kevin",(R),Thrivent Financial,12000,9000,3000
"Cramer, Kevin",(R),Susan B Anthony List,11950,1100,10850
"Cramer, Kevin",(R),Scheels All Sports,11800,0,11800
"Cramer, Kevin",(R),Midcontinent Media,11300,0,11300
"Cramer, Kevin",(R),National Assn of Realtors,11250,11000,250
"Cramer, Kevin",(R),Corwin Automotive Group,11100,0,11100
"Cramer, Kevin",(R),Cargill Inc,11075,0,11075
"Cramer, Kevin",(R),International Bank of Commerce,11017,5200,5817
"Cramer, Kevin",(R),Agman Partners,10800,0,10800
"Cramer, Kevin",(R),Arizona Diamondbacks,10800,0,10800
"Cramer, Kevin",(R),Baker Boy,10800,0,10800
"Cramer, Kevin",(R),Bauer Honey,10800,0,10800
"Cramer, Kevin",(R),Bernard Marcus Family Foundation,10800,0,10800
"Cramer, Kevin",(R),Beverage Wholesalers Inc,10800,0,10800
"Cramer, Kevin",(R),Bluff Point Assoc,10800,0,10800
"Cramer, Kevin",(R),Brown-Forman Corp,10800,0,10800
"Cramer, Kevin",(R),Charles Schwab Corp,10800,0,10800
"Cramer, Kevin",(R),Continental Investors,10800,0,10800
"Cramer, Kevin",(R),Environmental Services Ltd,10800,0,10800
"Cramer, Kevin",(R),Fisher Industries,10800,0,10800
"Cramer, Kevin",(R),Franklin Resources,10800,0,10800
"Cramer, Kevin",(R),Harbour Group Industries,10800,0,10800
"Cramer, Kevin",(R),HJ Kalikow & Co,10800,0,10800
"Cramer, Kevin",(R),JW Childs Assoc,10800,0,10800
"Cramer, Kevin",(R),Kent Companies,10800,0,10800
"Cramer, Kevin",(R),Lone Star Funds,10800,0,10800
"Cramer, Kevin",(R),Madison Dearborn Partners,10800,0,10800
"Cramer, Kevin",(R),Miller Insulation,10800,0,10800
"Cramer, Kevin",(R),North American Holdings,10800,0,10800
"Cramer, Kevin",(R),Nuveria,10800,0,10800
"Cramer, Kevin",(R),Red Apple Group,10800,0,10800
"Cramer, Kevin",(R),Thornton Oil,10800,0,10800
"Cramer, Kevin",(R),TPG Capital,10800,0,10800
"Cramer, Kevin",(R),Truenorth Steel,10800,0,10800
"Cramer, Kevin",(R),Vance Street Capital,10800,0,10800
"Cramer, Kevin",(R),"Welsh, Carson et al",10800,0,10800
"Cramer, Kevin",(R),Prescott Investors,10500,0,10500
"Cramer, Kevin",(R),Lignite Energy Council,10250,10000,250
"Cramer, Kevin",(R),US Bancorp,10210,7500,2710
"Cramer, Kevin",(R),Northrop Grumman,10125,10000,125
"Cramer, Kevin",(R),Titan Machinery,10100,0,10100
"Cramer, Kevin",(R),Kindred Healthcare,10082,7500,2582
"Cramer, Kevin",(R),American Crystal Sugar,10030,10000,30
"Cramer, Kevin",(R),American Bankers Assn,10025,10000,25
"Cramer, Kevin",(R),American Dental Assn,10000,10000,0
"Cramer, Kevin",(R),Bluegrass Cmte,10000,10000,0
"Cramer, Kevin",(R),Charter Communications,10000,10000,0
"Cramer, Kevin",(R),Citizens for Prosperity in America Today,10000,10000,0
"Cramer, Kevin",(R),Cloud Peak Energy Resources,10000,10000,0
"Cramer, Kevin",(R),Common Values PAC,10000,10000,0
"Cramer, Kevin",(R),Dakota PAC,10000,10000,0
"Cramer, Kevin",(R),Delta Air Lines,10000,10000,0
"Cramer, Kevin",(R),Fund for a Conservative Future,10000,10000,0
"Cramer, Kevin",(R),Heartland Values PAC,10000,10000,0
"Cramer, Kevin",(R),HellerHighWater PAC,10000,10000,0
"Cramer, Kevin",(R),Home Depot,10000,10000,0
"Cramer, Kevin",(R),ICE PAC,10000,10000,0
"Crapo, Mike",(R),Capital Group Companies,141800,50000,91800
"Crapo, Mike",(R),Carlyle Group,104200,0,104200
"Crapo, Mike",(R),Watco Companies,88220,0,88220
"Crapo, Mike",(R),Stephens Inc,81200,0,81200
"Crapo, Mike",(R),Votesane PAC,75150,0,75150
"Crapo, Mike",(R),MetLife Inc,74750,37000,37750
"Crapo, Mike",(R),Amgen Inc,73200,31500,41700
"Crapo, Mike",(R),Fresenius Medical Care,73200,51000,22200
"Crapo, Mike",(R),PNC Financial Services,71500,70500,1000
"Crapo, Mike",(R),Fidelity Investments,65000,37500,27500
"Crapo, Mike",(R),New York Life Insurance,64450,26000,38450
"Crapo, Mike",(R),Blue Cross/Blue Shield,64000,63000,1000
"Crapo, Mike",(R),UnitedHealth Group,62700,37500,25200
"Crapo, Mike",(R),Blackstone Group,59500,1000,58500
"Crapo, Mike",(R),Pfizer Inc,58500,37500,21000
"Crapo, Mike",(R),America's Credit Unions,56500,52500,4000
"Crapo, Mike",(R),Apollo Global Management,54700,1500,53200
"Crapo, Mike",(R),Clearpath Foundation,49800,0,49800
"Crapo, Mike",(R),Sinclair Companies,48500,0,48500
"Crapo, Mike",(R),Sullivan & Cromwell,48250,0,48250
"Crapo, Mike",(R),Goldman Sachs,48200,39500,8700
"Crapo, Mike",(R),JPMorgan Chase & Co,47950,33000,14950
"Crapo, Mike",(R),Zions Bancorp,46100,2700,43400
"Crapo, Mike",(R),CME Group,44000,44000,0
"Crapo, Mike",(R),CVS Health,43500,43500,0
"Crapo, Mike",(R),Merck & Co,42500,35000,7500
"Crapo, Mike",(R),1st Financial Bank USA,41200,0,41200
"Crapo, Mike",(R),Mortgage Bankers Assn,41000,40000,1000
"Crapo, Mike",(R),American Institute of CPAs,40000,40000,0
"Crapo, Mike",(R),Automotive Free International Trade PAC,40000,40000,0
"Crapo, Mike",(R),Hewlett Packard Enterprise,40000,40000,0
"Crapo, Mike",(R),Independent Community Bankers of America,40000,40000,0
"Crapo, Mike",(R),KPMG LLP,40000,40000,0
"Crapo, Mike",(R),National Assn of Home Builders,40000,40000,0
"Crapo, Mike",(R),National Assn of Real Estate Investment Trusts,40000,40000,0
"Crapo, Mike",(R),National Multifamily Housing Council,40000,40000,0
"Crapo, Mike",(R),USAA,40000,40000,0
"Crapo, Mike",(R),Quicken Loans,39900,3500,36400
"Crapo, Mike",(R),American Hospital Assn,39000,39000,0
"Crapo, Mike",(R),US Bancorp,38500,38000,500
"Crapo, Mike",(R),Wells Fargo,38500,19000,19500
"Crapo, Mike",(R),Regions Financial,38000,38000,0
"Crapo, Mike",(R),National Assn of Realtors,37990,37990,0
"Crapo, Mike",(R),Fidelity National Financial,37920,7920,30000
"Crapo, Mike",(R),Consumer Bankers Assn,37500,37500,0
"Crapo, Mike",(R),Union Pacific Corp,37500,37500,0
"Crapo, Mike",(R),United Parcel Service,36200,36200,0
"Crapo, Mike",(R),Royal Bank of Canada,35500,10000,25500
"Crapo, Mike",(R),American Land Title Assn,35000,35000,0
"Crapo, Mike",(R),American Medical Assn,35000,35000,0
"Crapo, Mike",(R),Deloitte LLP,35000,35000,0
"Crapo, Mike",(R),Honeywell International,35000,35000,0
"Crapo, Mike",(R),Independent Insurance Agents & Brokers of America,35000,35000,0
"Crapo, Mike",(R),Thrivent Financial,35000,28000,7000
"Crapo, Mike",(R),Visa Inc,35000,35000,0
"Crapo, Mike",(R),DaVita Inc,33500,31000,2500
"Crapo, Mike",(R),Investment Co Institute,33500,33500,0
"Crapo, Mike",(R),Northrop Grumman,33500,33500,0
"Crapo, Mike",(R),Prudential Financial,33500,31500,2000
"Crapo, Mike",(R),Abbott Laboratories,32500,32500,0
"Crapo, Mike",(R),Capital One Financial,32500,32500,0
"Crapo, Mike",(R),Genesee & Wyoming,31500,23100,8400
"Crapo, Mike",(R),American Bankers Assn,31000,29500,1500
"Crapo, Mike",(R),Citigroup Inc,31000,30000,1000
"Crapo, Mike",(R),Humana Inc,30500,30500,0
"Crapo, Mike",(R),Wine & Spirits Wholesalers of America,30499,30499,0
"Crapo, Mike",(R),American Council of Life Insurers,30000,30000,0
"Crapo, Mike",(R),Bank of New York Mellon,30000,30000,0
"Crapo, Mike",(R),Home Depot,30000,30000,0
"Crapo, Mike",(R),National Auto Dealers Assn,30000,30000,0
"Crapo, Mike",(R),UBS Americas,28300,25000,3300
"Crapo, Mike",(R),AFLAC Inc,28000,28000,0
"Crapo, Mike",(R),American Property Casualty Insurance Assn,28000,28000,0
"Crapo, Mike",(R),Pharmaceutical Research & Manufacturers Of America,27500,16000,11500
"Crapo, Mike",(R),Travelers Companies,27500,27500,0
"Crapo, Mike",(R),Ernst & Young,27000,26500,500
"Crapo, Mike",(R),Harbinger Strategies,27000,0,27000
"Crapo, Mike",(R),Agri Beef,26800,0,26800
"Crapo, Mike",(R),Truist Financial,26500,26500,0
"Crapo, Mike",(R),Pacific Companies,26300,0,26300
"Crapo, Mike",(R),Walmart Inc,26025,26000,25
"Crapo, Mike",(R),Federal Reserve Board,26000,0,26000
"Crapo, Mike",(R),National Assn of Mutual Insurance Companies,26000,24000,2000
"Crapo, Mike",(R),Micron Technology,25950,20000,5950
"Crapo, Mike",(R),Plummer Forest Products,25800,0,25800
"Crapo, Mike",(R),Berkshire Hathaway,25500,25000,500
"Crapo, Mike",(R),Bristol-Myers Squibb,25000,15000,10000
"Crapo, Mike",(R),Depository Trust & Clearing Corp,25000,25000,0
"Crapo, Mike",(R),National Beer Wholesalers Assn,25000,25000,0
"Crapo, Mike",(R),Delta Strategy Group,24528,0,24528
"Crapo, Mike",(R),AbbVie Inc,24500,24500,0
"Crapo, Mike",(R),Credit Suisse Group,24500,24000,500
"Crapo, Mike",(R),Massachusetts Mutual Life Insurance,24500,20500,4000
"Crapo, Mike",(R),Guardian Life Insurance,24000,16000,8000
"Crapo, Mike",(R),Northwestern Mutual Life Insurance,24000,20000,4000
"Crapo, Mike",(R),T-Mobile USA,24000,24000,0
"Crapo, Mike",(R),Comcast Corp,23500,22500,1000
"Crapo, Mike",(R),American Assn of Nurse Anesthetists,23000,23000,0
"Crapo, Mike",(R),Bayer AG,23000,23000,0
"Crapo, Mike",(R),TPG Capital,22900,0,22900
"Cruz, Ted",(R),Senate Conservatives Fund,276588,0,276588
"Cruz, Ted",(R),Club for Growth,234832,0,234832
"Cruz, Ted",(R),Woodforest Financial Group,148201,0,148201
"Cruz, Ted",(R),Berkshire Hathaway,103128,40000,63128
"Cruz, Ted",(R),Lockheed Martin,99570,42000,57570
"Cruz, Ted",(R),NorPAC,93950,0,93950
"Cruz, Ted",(R),Sullivan & Cromwell,72913,0,72913
"Cruz, Ted",(R),Delta Air Lines,68484,22500,45984
"Cruz, Ted",(R),Insperity,67025,0,67025
"Cruz, Ted",(R),Stewart Title Guaranty,65965,0,65965
"Cruz, Ted",(R),Jennmar Corp,65700,0,65700
"Cruz, Ted",(R),Sutton Ventures Group,61800,0,61800
"Cruz, Ted",(R),Avalon Advisors,60700,0,60700
"Cruz, Ted",(R),Doggett Industries,57200,0,57200
"Cruz, Ted",(R),Rida Development,57000,0,57000
"Cruz, Ted",(R),USAA,56838,25000,31838
"Cruz, Ted",(R),Hilcorp Energy,54518,0,54518
"Cruz, Ted",(R),Ryan LLC,52666,20000,32666
"Cruz, Ted",(R),JW Childs Assoc,52400,0,52400
"Cruz, Ted",(R),Stewart & Stevenson,52400,0,52400
"Cruz, Ted",(R),Lodge Lumber,52165,0,52165
"Cruz, Ted",(R),Southwest Airlines,51596,5998,45598
"Cruz, Ted",(R),Herzog,50500,5000,45500
"Cruz, Ted",(R),American Airlines Group,50328,19000,31328
"Cruz, Ted",(R),Valero Energy,50019,24000,26019
"Cruz, Ted",(R),Bluewater International,49900,0,49900
"Cruz, Ted",(R),AT&T Inc,48670,35000,13670
"Cruz, Ted",(R),"Gibson, Dunn & Crutcher",48050,0,48050
"Cruz, Ted",(R),Chevron Corp,47745,14000,33745
"Cruz, Ted",(R),Union Pacific Corp,47550,40000,7550
"Cruz, Ted",(R),Southern Glazer's Wine & Spirits,47425,0,47425
"Cruz, Ted",(R),MIDDLETON OIL CO,47000,0,47000
"Cruz, Ted",(R),Cinemark USA,45800,0,45800
"Cruz, Ted",(R),Greenberg Traurig LLP,45210,2500,42710
"Cruz, Ted",(R),Cooper & Kirk,44600,0,44600
"Cruz, Ted",(R),Hudson River Trading,44100,0,44100
"Cruz, Ted",(R),Pbf Energy,43560,0,43560
"Cruz, Ted",(R),Duty Free Americas,43200,0,43200
"Cruz, Ted",(R),Goldman Sachs,42675,5000,37675
"Cruz, Ted",(R),Republican Jewish Coalition,42474,10000,32474
"Cruz, Ted",(R),Ariel Corp,41600,0,41600
"Cruz, Ted",(R),Deason Capital Services,40800,0,40800
"Cruz, Ted",(R),Saulsbury Industries,40730,0,40730
"Cruz, Ted",(R),State of Texas,40402,0,40402
"Cruz, Ted",(R),Comcast Corp,39765,25000,14765
"Cruz, Ted",(R),Huffines Communities,39700,0,39700
"Cruz, Ted",(R),UnitedHealth Group,39384,2500,36884
"Cruz, Ted",(R),Hicks Holdings,39060,0,39060
"Cruz, Ted",(R),Mirand Response Systems,38900,0,38900
"Cruz, Ted",(R),University of Texas,38784,0,38784
"Cruz, Ted",(R),Interstate Batteries,38500,0,38500
"Cruz, Ted",(R),Debusk Services Group,38300,0,38300
"Cruz, Ted",(R),Accenture,37809,15000,22809
"Cruz, Ted",(R),Platinum Health Care,37400,0,37400
"Cruz, Ted",(R),Republic National Distributing,37400,0,37400
"Cruz, Ted",(R),Quantum Energy Partners,37100,0,37100
"Cruz, Ted",(R),Exxon Mobil,36997,10000,26997
"Cruz, Ted",(R),JAT Capital Partners,36600,0,36600
"Cruz, Ted",(R),Oberheiden Pc,36600,0,36600
"Cruz, Ted",(R),FedEx Corp,36560,22000,14560
"Cruz, Ted",(R),Honeywell International,36255,26000,10255
"Cruz, Ted",(R),Citadel LLC,36200,0,36200
"Cruz, Ted",(R),Bechtel Group,36016,0,36016
"Cruz, Ted",(R),Apollo Global Management,35650,0,35650
"Cruz, Ted",(R),Desert Royalty Co,35600,0,35600
"Cruz, Ted",(R),Henry Resources,33437,0,33437
"Cruz, Ted",(R),Wilks Brothers,33028,0,33028
"Cruz, Ted",(R),Morgan Lewis LLP,32966,0,32966
"Cruz, Ted",(R),Credit Suisse Group,32200,0,32200
"Cruz, Ted",(R),Occidental Petroleum,32184,7500,24684
"Cruz, Ted",(R),Heavy Construction Systems Specialists,32050,0,32050
"Cruz, Ted",(R),RE Janes Gravel Co,31600,0,31600
"Cruz, Ted",(R),Texas Transeastern,31600,0,31600
"Cruz, Ted",(R),US Government,31084,0,31084
"Cruz, Ted",(R),Arizona Diamondbacks,30800,0,30800
"Cruz, Ted",(R),Baker Botts LLP,30625,1000,29625
"Cruz, Ted",(R),US Army,30375,0,30375
"Cruz, Ted",(R),Mister Sweeper LP,30000,0,30000
"Cruz, Ted",(R),Norfolk Southern,30000,30000,0
"Cruz, Ted",(R),Expand Energy,29485,2500,26985
"Cruz, Ted",(R),US Anesthesia Partners,29316,0,29316
"Cruz, Ted",(R),McCombs Enterprises,29300,0,29300
"Cruz, Ted",(R),Taste of Texas Restaurant,29300,0,29300
"Cruz, Ted",(R),Warburg Pincus,29220,0,29220
"Cruz, Ted",(R),Bank of America,29147,0,29147
"Cruz, Ted",(R),Boeing Co,29132,10000,19132
"Cruz, Ted",(R),Research Affiliates LLC,28700,0,28700
"Cruz, Ted",(R),Williams Brothers Construction,28700,0,28700
"Cruz, Ted",(R),KKR & Co,28653,0,28653
"Cruz, Ted",(R),Dell Technologies,28510,14000,14510
"Cruz, Ted",(R),Redman Management,28400,0,28400
"Cruz, Ted",(R),Discovery Operating,28000,0,28000
"Cruz, Ted",(R),Jackson Walker Llp,27317,0,27317
"Cruz, Ted",(R),Northrop Grumman,27227,20000,7227
"Cruz, Ted",(R),Crow Holdings,27200,0,27200
"Cruz, Ted",(R),Giles & O'Malley,27000,0,27000
"Cruz, Ted",(R),Tennessee Industrial Electronics,26700,0,26700
"Cruz, Ted",(R),Mid States Operating Co,26400,0,26400
"Cruz, Ted",(R),Sage Energy,26400,0,26400
"Cruz, Ted",(R),Anthem Ventures,26200,0,26200
"Daines, Steven",(R),Senate Conservatives Fund,295841,10000,285841
"Daines, Steven",(R),Club for Growth,109971,0,109971
"Daines, Steven",(R),Charter Communications,81124,40000,41124
"Daines, Steven",(R),Susan B Anthony List,65125,7900,57225
"Daines, Steven",(R),Langlas & Assoc,64102,0,64102
"Daines, Steven",(R),Republican Jewish Coalition,62058,9209,52849
"Daines, Steven",(R),Procter & Gamble,56499,9000,47499
"Daines, Steven",(R),Berkshire Hathaway,55241,40000,15241
"Daines, Steven",(R),Amgen Inc,54630,26000,28630
"Daines, Steven",(R),Blackstone Group,53911,0,53911
"Daines, Steven",(R),Microsoft Corp,52722,37500,15222
"Daines, Steven",(R),New York Life Insurance,49628,35000,14628
"Daines, Steven",(R),Barnard Construction,47845,0,47845
"Daines, Steven",(R),FedEx Corp,47523,35500,12023
"Daines, Steven",(R),United Parcel Service,46556,37500,9056
"Daines, Steven",(R),Northrop Grumman,45170,38500,6670
"Daines, Steven",(R),National Republican Senatorial Cmte,44625,44600,25
"Daines, Steven",(R),Altria Group,44300,30000,14300
"Daines, Steven",(R),Deloitte LLP,42337,40000,2337
"Daines, Steven",(R),Honeywell International,42005,38500,3505
"Daines, Steven",(R),Sinclair Companies,41750,0,41750
"Daines, Steven",(R),Home Depot,41208,35500,5708
"Daines, Steven",(R),NorPAC,40770,0,40770
"Daines, Steven",(R),Sequoia Capital,40700,0,40700
"Daines, Steven",(R),NextEra Energy,39899,16500,23399
"Daines, Steven",(R),Goldman Sachs,39225,20000,19225
"Daines, Steven",(R),Saulsbury Industries,39200,0,39200
"Daines, Steven",(R),GBX Group,38750,0,38750
"Daines, Steven",(R),Blue Cross/Blue Shield,38485,36000,2485
"Daines, Steven",(R),Ignition Partners,38075,0,38075
"Daines, Steven",(R),Union Pacific Corp,36035,33000,3035
"Daines, Steven",(R),Hewlett Packard Enterprise,35821,35500,321
"Daines, Steven",(R),Wells Fargo,35401,12000,23401
"Daines, Steven",(R),T-Mobile USA,35040,29000,6040
"Daines, Steven",(R),American Hotel & Lodging Assn,35000,35000,0
"Daines, Steven",(R),California Dairies Inc,35000,35000,0
"Daines, Steven",(R),National Auto Dealers Assn,35000,35000,0
"Daines, Steven",(R),Elliott Management,33500,0,33500
"Daines, Steven",(R),Yellowstone Bank,32600,0,32600
"Daines, Steven",(R),NCTA The Internet & Television Assn,32500,32500,0
"Daines, Steven",(R),General Dynamics,31543,25000,6543
"Daines, Steven",(R),Wine & Spirits Wholesalers of America,31000,31000,0
"Daines, Steven",(R),Southern Co,29815,29000,815
"Daines, Steven",(R),Comcast Corp,29238,27500,1738
"Daines, Steven",(R),Delta Air Lines,28416,21000,7416
"Daines, Steven",(R),Lockheed Martin,28279,10000,18279
"Daines, Steven",(R),Agua Caliente Band of Cahuilla Indians,28000,0,28000
"Daines, Steven",(R),Steelhead Partners,28000,0,28000
"Daines, Steven",(R),CSX Corp,27924,27500,424
"Daines, Steven",(R),Chevron Corp,27698,10000,17698
"Daines, Steven",(R),Mortgage Bankers Assn,27000,27000,0
"Daines, Steven",(R),"National Stone, Sand & Gravel Assn",27000,27000,0
"Daines, Steven",(R),Bank of America,26936,1000,25936
"Daines, Steven",(R),BGR Group,26775,925,25850
"Daines, Steven",(R),United Dairy Farmers,26650,0,26650
"Daines, Steven",(R),DISH Network,26550,10000,16550
"Daines, Steven",(R),Melrose Industries,26438,0,26438
"Daines, Steven",(R),TA Assoc,26300,9500,16800
"Daines, Steven",(R),CC Clark Inc,25720,0,25720
"Daines, Steven",(R),Boeing Co,25554,10000,15554
"Daines, Steven",(R),Norfolk Southern,25260,25000,260
"Daines, Steven",(R),"Cohen, Klingenstein & Marks",25200,0,25200
"Daines, Steven",(R),Laborers Union,25075,25000,75
"Daines, Steven",(R),Automotive Free International Trade PAC,25000,25000,0
"Daines, Steven",(R),International Franchise Assn,25000,25000,0
"Daines, Steven",(R),National Beer Wholesalers Assn,25000,25000,0
"Daines, Steven",(R),National Multifamily Housing Council,25000,25000,0
"Daines, Steven",(R),Walmart Inc,24990,16000,8990
"Daines, Steven",(R),AT&T Inc,24974,17500,7474
"Daines, Steven",(R),National Air Traffic Controllers Assn,24500,24500,0
"Daines, Steven",(R),Rock Holdings,24500,12000,12500
"Daines, Steven",(R),Air Line Pilots Assn,23500,23500,0
"Daines, Steven",(R),National Assn of Broadcasters,23000,21500,1500
"Daines, Steven",(R),National Assn of Convenience Stores,23000,23000,0
"Daines, Steven",(R),American Dental Assn,22950,22500,450
"Daines, Steven",(R),"Akin, Gump et al",22770,6500,16270
"Daines, Steven",(R),Koch Inc,22530,20000,2530
"Daines, Steven",(R),Koch Industries,22500,20000,2500
"Daines, Steven",(R),US Government,22405,0,22405
"Daines, Steven",(R),National Assn of Realtors,22000,20000,2000
"Daines, Steven",(R),Quicken Loans,22000,0,22000
"Daines, Steven",(R),"Bryan, Cave et al",21958,19000,2958
"Daines, Steven",(R),Charles Schwab Corp,21938,8000,13938
"Daines, Steven",(R),Verizon Communications,21591,19000,2591
"Daines, Steven",(R),General Motors,21585,19000,2585
"Daines, Steven",(R),Teamworthy Group,21400,0,21400
"Daines, Steven",(R),Fisher Investments,21200,0,21200
"Daines, Steven",(R),KKR & Co,21097,1500,19597
"Daines, Steven",(R),Association of KFC Franchisees,21000,21000,0
"Daines, Steven",(R),Independent Community Bankers of America,21000,21000,0
"Daines, Steven",(R),Genentech Inc,20861,17500,3361
"Daines, Steven",(R),National Assn of Real Estate Investment Trusts,20750,20500,250
"Daines, Steven",(R),Democracy Engine,20450,0,20450
"Daines, Steven",(R),US House of Representatives,20335,0,20335
"Daines, Steven",(R),"Brownstein, Hyatt et al",20250,10500,9750
"Daines, Steven",(R),Amazon.com,20235,9500,10735
"Daines, Steven",(R),Town Pump Inc,20025,0,20025
"Daines, Steven",(R),Credit Union National Assn,20000,20000,0
"Daines, Steven",(R),Regions Financial,19877,19500,377
"Daines, Steven",(R),Crossharbor Capital Partners,19500,0,19500
"Duckworth, Tammy",(D),EMILY's List,426574,8275,418299
"Duckworth, Tammy",(D),JStreetPAC,194437,5000,189437
"Duckworth, Tammy",(D),League of Conservation Voters,179310,13000,166310
"Duckworth, Tammy",(D),Simmons Hanly Conroy,131775,0,131775
"Duckworth, Tammy",(D),Willis Towers Watson,51944,0,51944
"Duckworth, Tammy",(D),Northrop Grumman,48528,42500,6028
"Duckworth, Tammy",(D),Democratic Senatorial Campaign Cmte,46800,46800,0
"Duckworth, Tammy",(D),Council for a Livable World,45087,0,45087
"Duckworth, Tammy",(D),Kirkland & Ellis,43878,0,43878
"Duckworth, Tammy",(D),United Food & Commercial Workers Union,38307,37500,807
"Duckworth, Tammy",(D),State of Illinois,36942,0,36942
"Duckworth, Tammy",(D),University of California,36843,0,36843
"Duckworth, Tammy",(D),Exelon Corp,35902,12500,23402
"Duckworth, Tammy",(D),Northwestern University,35601,0,35601
"Duckworth, Tammy",(D),University of Illinois,35175,0,35175
"Duckworth, Tammy",(D),American Maritime Officers,35000,35000,0
"Duckworth, Tammy",(D),Cooney & Conway,34265,0,34265
"Duckworth, Tammy",(D),Blue Cross/Blue Shield,33384,17000,16384
"Duckworth, Tammy",(D),Select Medical Corp,33078,25000,8078
"Duckworth, Tammy",(D),Honeywell International,32905,32500,405
"Duckworth, Tammy",(D),Winston & Strawn,32410,10400,22010
"Duckworth, Tammy",(D),University of Chicago,32409,0,32409
"Duckworth, Tammy",(D),Air Line Pilots Assn,32063,30000,2063
"Duckworth, Tammy",(D),American Assn of Orthopaedic Surgeons,32000,32000,0
"Duckworth, Tammy",(D),VoteVets.org,32000,32000,0
"Duckworth, Tammy",(D),International Brotherhood of Electrical Workers,31523,30000,1523
"Duckworth, Tammy",(D),L3Harris Technologies,30775,28000,2775
"Duckworth, Tammy",(D),American Crystal Sugar,30000,30000,0
"Duckworth, Tammy",(D),Deloitte LLP,29702,27500,2202
"Duckworth, Tammy",(D),Womencount PAC,28083,848,27235
"Duckworth, Tammy",(D),American Orthotic & Prosthetic Assn,26449,22500,3949
"Duckworth, Tammy",(D),Berkshire Hathaway,26245,25000,1245
"Duckworth, Tammy",(D),Comcast Corp,26241,20000,6241
"Duckworth, Tammy",(D),Union Pacific Corp,26130,25000,1130
"Duckworth, Tammy",(D),"Sheet Metal, Air, Rail & Transportation Union",26000,26000,0
"Duckworth, Tammy",(D),Home Depot,25338,25000,338
"Duckworth, Tammy",(D),Cigna Corp,25123,24500,623
"Duckworth, Tammy",(D),AbbVie Inc,25109,23500,1609
"Duckworth, Tammy",(D),Poet LLC,25000,20000,5000
"Duckworth, Tammy",(D),Clifford Law Offices,24550,0,24550
"Duckworth, Tammy",(D),Motorola Solutions,24315,24000,315
"Duckworth, Tammy",(D),Pfizer Inc,24218,21000,3218
"Duckworth, Tammy",(D),"Bartlit, Beck et al",24100,0,24100
"Duckworth, Tammy",(D),Thornton Law Firm,23500,0,23500
"Duckworth, Tammy",(D),"Akin, Gump et al",23425,250,23175
"Duckworth, Tammy",(D),AT&T Inc,23381,9500,13881
"Duckworth, Tammy",(D),American Assn for Justice,22400,22000,400
"Duckworth, Tammy",(D),Motley Rice LLC,22290,0,22290
"Duckworth, Tammy",(D),Phosplatin Therapeutics,22000,0,22000
"Duckworth, Tammy",(D),Mesirow Financial,21750,0,21750
"Duckworth, Tammy",(D),UnitedHealth Group,21605,20000,1605
"Duckworth, Tammy",(D),Rmk Management,21400,0,21400
"Duckworth, Tammy",(D),National Air Traffic Controllers Assn,21250,21250,0
"Duckworth, Tammy",(D),Anheuser-Busch,21000,21000,0
"Duckworth, Tammy",(D),NCTA The Internet & Television Assn,21000,21000,0
"Duckworth, Tammy",(D),Brandenburg Industrial Service,20800,0,20800
"Duckworth, Tammy",(D),"City of Chicago, IL",20512,0,20512
"Duckworth, Tammy",(D),Corboy & Demetrio,20500,0,20500
"Duckworth, Tammy",(D),Teamsters Union,20100,20000,100
"Duckworth, Tammy",(D),American Federation of State/Cnty/Munic Employees,20078,20000,78
"Duckworth, Tammy",(D),Cboe Global Markets,20075,15000,5075
"Duckworth, Tammy",(D),UNITE HERE,20025,20000,25
"Duckworth, Tammy",(D),Bricklayers Union,20020,20000,20
"Duckworth, Tammy",(D),National Assn of Letter Carriers,20020,15000,5020
"Duckworth, Tammy",(D),Aircraft Owners & Pilots Assn,20000,20000,0
"Duckworth, Tammy",(D),CSX Corp,20000,20000,0
"Duckworth, Tammy",(D),Great Lakes PAC,20000,20000,0
"Duckworth, Tammy",(D),Prairie PAC,20000,20000,0
"Duckworth, Tammy",(D),Bucher Medical Services,19950,0,19950
"Duckworth, Tammy",(D),AAR Corp,19500,8200,11300
"Duckworth, Tammy",(D),Serve America PAC,19200,19200,0
"Duckworth, Tammy",(D),Power Rogers LLP,18700,0,18700
"Duckworth, Tammy",(D),Growth Energy,18500,18500,0
"Duckworth, Tammy",(D),American Federation of Teachers,18369,17500,869
"Duckworth, Tammy",(D),"Buchanan, Ingersoll & Rooney",18180,0,18180
"Duckworth, Tammy",(D),US Dept of Veterans Affairs,17662,0,17662
"Duckworth, Tammy",(D),Sidley Austin LLP,17650,1000,16650
"Duckworth, Tammy",(D),Charter Communications,17628,17500,128
"Duckworth, Tammy",(D),RTX Corp,17619,16000,1619
"Duckworth, Tammy",(D),MRHFM Law Firm,17583,0,17583
"Duckworth, Tammy",(D),USAA,17570,17500,70
"Duckworth, Tammy",(D),Transport Workers Union,17500,17500,0
"Duckworth, Tammy",(D),Bend The Arc Jewish Action,17151,10000,7151
"Duckworth, Tammy",(D),United Airlines Holdings,16746,7000,9746
"Duckworth, Tammy",(D),GCM Grosvenor,16700,0,16700
"Duckworth, Tammy",(D),US Dept of Energy,16472,0,16472
"Duckworth, Tammy",(D),Google Inc,16460,6500,9960
"Duckworth, Tammy",(D),DLA Piper,16355,0,16355
"Duckworth, Tammy",(D),Centene Corp,16307,2500,13807
"Duckworth, Tammy",(D),Development Specialists Inc,16210,0,16210
"Duckworth, Tammy",(D),Artery Capital Group,16200,0,16200
"Duckworth, Tammy",(D),Couponcabin.Com,16200,0,16200
"Duckworth, Tammy",(D),Labelmaster,16200,0,16200
"Duckworth, Tammy",(D),Segal Co,16056,0,16056
"Duckworth, Tammy",(D),Abelson Taylor,15800,0,15800
"Duckworth, Tammy",(D),National Assn of Broadcasters,15750,14500,1250
"Duckworth, Tammy",(D),Baker & McKenzie,15600,0,15600
"Duckworth, Tammy",(D),Ironworkers Union,15500,15500,0
"Duckworth, Tammy",(D),"Newmark, Grubb et al",15500,0,15500
"Duckworth, Tammy",(D),Urban Innovations,15500,0,15500
"Durbin, Dick",(D),Power Rogers LLP,172299,0,172299
"Durbin, Dick",(D),Cooney & Conway,158133,0,158133
"Durbin, Dick",(D),Simmons Hanly Conroy,152650,0,152650
"Durbin, Dick",(D),Clifford Law Offices,114000,0,114000
"Durbin, Dick",(D),"Keefe, Keefe & Unsell",106800,0,106800
"Durbin, Dick",(D),State of Illinois,90685,0,90685
"Durbin, Dick",(D),Kirkland & Ellis,77751,0,77751
"Durbin, Dick",(D),Comcast Corp,64121,40000,24121
"Durbin, Dick",(D),CME Group,64113,40000,24113
"Durbin, Dick",(D),Korein Tillery Llc,62700,0,62700
"Durbin, Dick",(D),General Dynamics,62175,38500,23675
"Durbin, Dick",(D),"Cook, Bartholomew et al",56830,0,56830
"Durbin, Dick",(D),MacAndrews & Forbes,56200,20000,36200
"Durbin, Dick",(D),Corboy & Demetrio,54320,0,54320
"Durbin, Dick",(D),Votesane PAC,51600,0,51600
"Durbin, Dick",(D),United Airlines Holdings,49567,10000,39567
"Durbin, Dick",(D),"Salvi, Schostok & Pritchard",48850,0,48850
"Durbin, Dick",(D),AAR Corp,47299,4400,42899
"Durbin, Dick",(D),Driscoll Firm,47100,0,47100
"Durbin, Dick",(D),National Beer Wholesalers Assn,45000,45000,0
"Durbin, Dick",(D),National Assn of Broadcasters,44500,28000,16500
"Durbin, Dick",(D),University of Illinois,42935,0,42935
"Durbin, Dick",(D),Northrop Grumman,42776,41000,1776
"Durbin, Dick",(D),"Gori, Julian & Assoc",42525,0,42525
"Durbin, Dick",(D),BAE Systems,42469,23500,18969
"Durbin, Dick",(D),Jenner & Block,41751,0,41751
"Durbin, Dick",(D),Berkshire Hathaway,41254,37500,3754
"Durbin, Dick",(D),Honeywell International,40056,31000,9056
"Durbin, Dick",(D),National Assn of Realtors,39575,34000,5575
"Durbin, Dick",(D),"Hurley, McKenna & Mertz",38900,0,38900
"Durbin, Dick",(D),National Multifamily Housing Council,37500,37500,0
"Durbin, Dick",(D),United Parcel Service,37488,35000,2488
"Durbin, Dick",(D),MRHFM Law Firm,37282,0,37282
"Durbin, Dick",(D),Home Depot,37094,35000,2094
"Durbin, Dick",(D),Huntington Ingalls Industries,36000,36000,0
"Durbin, Dick",(D),Norfolk Southern,35060,35000,60
"Durbin, Dick",(D),International Assn of Fire Fighters,35000,35000,0
"Durbin, Dick",(D),Air Line Pilots Assn,34069,31500,2569
"Durbin, Dick",(D),National Education Assn,32768,32000,768
"Durbin, Dick",(D),Lockheed Martin,32509,32500,9
"Durbin, Dick",(D),American Hotel & Lodging Assn,32500,32500,0
"Durbin, Dick",(D),Microsoft Corp,32470,20500,11970
"Durbin, Dick",(D),American Federation of Teachers,32225,31000,1225
"Durbin, Dick",(D),Blue Cross/Blue Shield,32160,30000,2160
"Durbin, Dick",(D),General Atomics,32150,17000,15150
"Durbin, Dick",(D),Livingston Group,32000,0,32000
"Durbin, Dick",(D),Woodbranch Investments,31800,0,31800
"Durbin, Dick",(D),Abelson Taylor,30990,0,30990
"Durbin, Dick",(D),Baker & McKenzie,30732,0,30732
"Durbin, Dick",(D),Peter G Peterson Foundation,30600,0,30600
"Durbin, Dick",(D),NCTA The Internet & Television Assn,30500,30000,500
"Durbin, Dick",(D),GCM Grosvenor,30400,0,30400
"Durbin, Dick",(D),Boeing Co,30387,28500,1887
"Durbin, Dick",(D),Union Pacific Corp,30065,30000,65
"Durbin, Dick",(D),University of Chicago,30015,0,30015
"Durbin, Dick",(D),CSX Corp,30000,30000,0
"Durbin, Dick",(D),"Londrigan, Potter & Randle",29711,0,29711
"Durbin, Dick",(D),Best Buy,29700,19000,10700
"Durbin, Dick",(D),Walmart Inc,28672,27000,1672
"Durbin, Dick",(D),American Hospital Assn,28053,27500,553
"Durbin, Dick",(D),Cboe Global Markets,27560,22500,5060
"Durbin, Dick",(D),National Assn of Real Estate Investment Trusts,27500,27500,0
"Durbin, Dick",(D),American Assn for Justice,27003,25000,2003
"Durbin, Dick",(D),Deloitte LLP,26010,25000,1010
"Durbin, Dick",(D),American Seniors Housing Assn,26000,26000,0
"Durbin, Dick",(D),J Street,25765,7000,18765
"Durbin, Dick",(D),Delta Air Lines,25114,25000,114
"Durbin, Dick",(D),Alzheimer's Assn,25078,15000,10078
"Durbin, Dick",(D),RTX Corp,25030,25000,30
"Durbin, Dick",(D),National Assn of Home Builders,25000,25000,0
"Durbin, Dick",(D),Physicians Mutual Insurance,25000,25000,0
"Durbin, Dick",(D),Wine & Spirits Wholesalers of America,25000,25000,0
"Durbin, Dick",(D),Simmons Law Firm,24950,0,24950
"Durbin, Dick",(D),Apollo Global Management,24843,0,24843
"Durbin, Dick",(D),Sidley Austin LLP,24129,0,24129
"Durbin, Dick",(D),Northwestern University,24080,0,24080
"Durbin, Dick",(D),Target Corp,24023,24000,23
"Durbin, Dick",(D),National Air Traffic Controllers Assn,24000,24000,0
"Durbin, Dick",(D),General Motors,23603,23500,103
"Durbin, Dick",(D),National Assn of Letter Carriers,23500,23500,0
"Durbin, Dick",(D),KKP Group,23012,0,23012
"Durbin, Dick",(D),Cullinan Properties,22760,0,22760
"Durbin, Dick",(D),National Restaurant Assn,22500,22500,0
"Durbin, Dick",(D),American Airlines,22212,16000,6212
"Durbin, Dick",(D),"Sheet Metal, Air, Rail & Transportation Union",22000,18500,3500
"Durbin, Dick",(D),"City of Chicago, IL",21870,0,21870
"Durbin, Dick",(D),HLP&R Advocacy,21800,0,21800
"Durbin, Dick",(D),Willis Towers Watson,21488,0,21488
"Durbin, Dick",(D),League of Conservation Voters,21329,12528,8801
"Durbin, Dick",(D),American Council of Engineering Cos,21000,21000,0
"Durbin, Dick",(D),Pan Am Equities,20800,0,20800
"Durbin, Dick",(D),Service Employees International Union,20390,15000,5390
"Durbin, Dick",(D),UFCW Local 881,20224,20000,224
"Durbin, Dick",(D),Raytheon Technologies,20083,19000,1083
"Durbin, Dick",(D),International Brotherhood of Electrical Workers,20070,20000,70
"Durbin, Dick",(D),National Assn of Convenience Stores,20010,20000,10
"Durbin, Dick",(D),Martin Defense Group,20000,0,20000
"Durbin, Dick",(D),Lettuce Entertain You,19599,0,19599
"Durbin, Dick",(D),American Institute of CPAs,19500,19500,0
"Durbin, Dick",(D),"Bartlit, Beck et al",19325,0,19325
"Ernst, Joni",(R),Votesane PAC,103200,0,103200
"Ernst, Joni",(R),Berkshire Hathaway,102058,30000,72058
"Ernst, Joni",(R),Blackstone Group,76583,0,76583
"Ernst, Joni",(R),Duty Free Americas,71600,0,71600
"Ernst, Joni",(R),Osmundson Manufacturing,60600,0,60600
"Ernst, Joni",(R),Poet LLC,60600,20000,40600
"Ernst, Joni",(R),Raytheon Technologies,59660,14500,45160
"Ernst, Joni",(R),McAninch Corp,55800,0,55800
"Ernst, Joni",(R),Renaissance Technologies,55800,0,55800
"Ernst, Joni",(R),Doll Distributing,54600,0,54600
"Ernst, Joni",(R),Great Point Partners,53200,0,53200
"Ernst, Joni",(R),NextEra Energy,50500,16000,34500
"Ernst, Joni",(R),NASCAR,48701,2500,46201
"Ernst, Joni",(R),KapStone Paper & Packaging,47050,0,47050
"Ernst, Joni",(R),Klinger Companies,46100,0,46100
"Ernst, Joni",(R),Kirke Financial Services,45780,0,45780
"Ernst, Joni",(R),Northrop Grumman,44828,37500,7328
"Ernst, Joni",(R),National Republican Senatorial Cmte,44638,44600,38
"Ernst, Joni",(R),American Bankers Assn,43620,40000,3620
"Ernst, Joni",(R),Alphabet Inc,43518,35000,8518
"Ernst, Joni",(R),HJ Kalikow & Co,42000,0,42000
"Ernst, Joni",(R),Bluff Point Assoc,41200,0,41200
"Ernst, Joni",(R),Terra Industries,41200,0,41200
"Ernst, Joni",(R),FedEx Corp,41178,24500,16678
"Ernst, Joni",(R),Mountaire Corp,41020,0,41020
"Ernst, Joni",(R),Cavalry Asset Management,41000,0,41000
"Ernst, Joni",(R),Tmc Transportation,41000,0,41000
"Ernst, Joni",(R),Bartlett Grain,40800,0,40800
"Ernst, Joni",(R),Davison Transport,40800,0,40800
"Ernst, Joni",(R),Sukup Manufacturing,39949,0,39949
"Ernst, Joni",(R),Croell Inc,39500,0,39500
"Ernst, Joni",(R),Comcast Corp,38926,35000,3926
"Ernst, Joni",(R),Elliott Management,38300,0,38300
"Ernst, Joni",(R),Denny Elwell Co,38052,0,38052
"Ernst, Joni",(R),Permira,37650,0,37650
"Ernst, Joni",(R),Union Pacific Corp,36705,32500,4205
"Ernst, Joni",(R),Kendall Hunt Publishing,36200,0,36200
"Ernst, Joni",(R),Wells Fargo,36062,10000,26062
"Ernst, Joni",(R),Prescott Investors,35650,0,35650
"Ernst, Joni",(R),Tigerrisk Partners,35400,0,35400
"Ernst, Joni",(R),IBM Corp,35321,0,35321
"Ernst, Joni",(R),Apollo,35000,0,35000
"Ernst, Joni",(R),Otis Eastern,34773,0,34773
"Ernst, Joni",(R),Honeywell International,34611,30500,4111
"Ernst, Joni",(R),"Welsh, Carson et al",34400,0,34400
"Ernst, Joni",(R),Ruan Companies,34100,5000,29100
"Ernst, Joni",(R),United Parcel Service,33746,29500,4246
"Ernst, Joni",(R),Chemorse Ltd,32950,0,32950
"Ernst, Joni",(R),Home Depot,32794,25000,7794
"Ernst, Joni",(R),Susan B Anthony List,32735,5000,27735
"Ernst, Joni",(R),RTX Corp,31940,20500,11440
"Ernst, Joni",(R),Republican Jewish Coalition,31752,7003,24749
"Ernst, Joni",(R),Lockheed Martin,31428,25000,6428
"Ernst, Joni",(R),Baker Botts LLP,31385,0,31385
"Ernst, Joni",(R),Iowa Select Farms,31250,0,31250
"Ernst, Joni",(R),Chilton Investments,31200,0,31200
"Ernst, Joni",(R),Cbe Companies,31050,0,31050
"Ernst, Joni",(R),Equity Dynamics Inc,31000,0,31000
"Ernst, Joni",(R),Growth Energy,31000,30000,1000
"Ernst, Joni",(R),JSC Properties,31000,0,31000
"Ernst, Joni",(R),Ariel Corp,30900,0,30900
"Ernst, Joni",(R),Northwest Excavating,30800,0,30800
"Ernst, Joni",(R),Cleveland Browns,30600,0,30600
"Ernst, Joni",(R),1st Financial Bank USA,30450,0,30450
"Ernst, Joni",(R),Brownells Inc,29400,0,29400
"Ernst, Joni",(R),Goldman Sachs,29125,13500,15625
"Ernst, Joni",(R),NorPAC,29000,0,29000
"Ernst, Joni",(R),Charles Schwab Corp,28939,1500,27439
"Ernst, Joni",(R),Apollo Global Management,28565,0,28565
"Ernst, Joni",(R),Putnam Investments,28362,1062,27300
"Ernst, Joni",(R),UBS AG,28259,15000,13259
"Ernst, Joni",(R),Deloitte LLP,28199,22500,5699
"Ernst, Joni",(R),Dian Graves Owen Foundation,28100,0,28100
"Ernst, Joni",(R),Equinox Partners,28100,0,28100
"Ernst, Joni",(R),Capital Group Companies,27925,12500,15425
"Ernst, Joni",(R),Hy-Vee Inc,27373,15000,12373
"Ernst, Joni",(R),BGR Group,27300,0,27300
"Ernst, Joni",(R),Westrock Capital Partners,26500,0,26500
"Ernst, Joni",(R),Kirkland & Ellis,26060,0,26060
"Ernst, Joni",(R),Charter Communications,25856,22500,3356
"Ernst, Joni",(R),Publix Super Markets,25779,5000,20779
"Ernst, Joni",(R),PricewaterhouseCoopers,25664,20000,5664
"Ernst, Joni",(R),Invus Group,25600,0,25600
"Ernst, Joni",(R),Magnolia Oil & Gas,25500,0,25500
"Ernst, Joni",(R),Berkshire Partners,25400,0,25400
"Ernst, Joni",(R),Lmbi Lp,25200,0,25200
"Ernst, Joni",(R),Kinze Manufacturing,25100,0,25100
"Ernst, Joni",(R),Shine Brothers Corp,25000,0,25000
"Ernst, Joni",(R),Prestage Farms,24500,0,24500
"Ernst, Joni",(R),Occidental Petroleum,24469,4000,20469
"Ernst, Joni",(R),Village Properties,24300,0,24300
"Ernst, Joni",(R),Wells Enterprises,24100,0,24100
"Ernst, Joni",(R),Blue Cross/Blue Shield,24083,12000,12083
"Ernst, Joni",(R),Freeman Spogli & Co,23800,0,23800
"Ernst, Joni",(R),Arbiter Partners,23400,0,23400
"Ernst, Joni",(R),Bill & Melinda Gates Foundation,23200,0,23200
"Ernst, Joni",(R),First Republic Bank,23100,0,23100
"Ernst, Joni",(R),Versova Management,23051,0,23051
"Ernst, Joni",(R),Teton Capital,22900,0,22900
"Ernst, Joni",(R),Bayer AG,22851,20000,2851
"Feinstein, Dianne",(D),EMILY's List,108450,10000,98450
"Feinstein, Dianne",(D),PG&E Corp,82476,37416,45060
"Feinstein, Dianne",(D),Edison International,80412,23400,57012
"Feinstein, Dianne",(D),General Dynamics,51520,26000,25520
"Feinstein, Dianne",(D),AT&T Inc,51022,42000,9022
"Feinstein, Dianne",(D),General Atomics,49025,21500,27525
"Feinstein, Dianne",(D),Pisces Inc,45900,0,45900
"Feinstein, Dianne",(D),Northrop Grumman,45348,38500,6848
"Feinstein, Dianne",(D),JPMorgan Chase & Co,42300,0,42300
"Feinstein, Dianne",(D),University of California,42033,0,42033
"Feinstein, Dianne",(D),SpaceX,41600,20000,21600
"Feinstein, Dianne",(D),Vail Resorts,40010,25000,15010
"Feinstein, Dianne",(D),Intel Corp,38310,27500,10810
"Feinstein, Dianne",(D),Holland & Knight,38150,14500,23650
"Feinstein, Dianne",(D),Comcast Corp,37905,25000,12905
"Feinstein, Dianne",(D),"Akin, Gump et al",36152,3250,32902
"Feinstein, Dianne",(D),Honeywell International,36000,36000,0
"Feinstein, Dianne",(D),Walt Disney Co,35925,16750,19175
"Feinstein, Dianne",(D),Estee Lauder Companies,34400,0,34400
"Feinstein, Dianne",(D),Salesforce.Com,33388,1000,32388
"Feinstein, Dianne",(D),JStreetPAC,32400,0,32400
"Feinstein, Dianne",(D),"Baker, Donelson et al",31000,9500,21500
"Feinstein, Dianne",(D),Pechanga Band of Luiseno Mission Indians,30600,0,30600
"Feinstein, Dianne",(D),Qualcomm Inc,30110,8500,21610
"Feinstein, Dianne",(D),McStrauss Co,30000,0,30000
"Feinstein, Dianne",(D),Democracy Engine,28699,0,28699
"Feinstein, Dianne",(D),"Casey, Gerry et al",28650,0,28650
"Feinstein, Dianne",(D),Ernst & Young,28000,27000,1000
"Feinstein, Dianne",(D),American Hotel & Lodging Assn,27500,27500,0
"Feinstein, Dianne",(D),"Manatt, Phelps & Phillips",27500,6700,20800
"Feinstein, Dianne",(D),Clean Energy Fuels Corp,26000,0,26000
"Feinstein, Dianne",(D),Yocha Dehe Wintun Nation,25400,0,25400
"Feinstein, Dianne",(D),Molina Healthcare,25300,4500,20800
"Feinstein, Dianne",(D),California Dairies Inc,25000,25000,0
"Feinstein, Dianne",(D),NCTA The Internet & Television Assn,25000,25000,0
"Feinstein, Dianne",(D),San Francisco Unified School District,24440,0,24440
"Feinstein, Dianne",(D),Wonderful Co,24300,0,24300
"Feinstein, Dianne",(D),Law Offices of Frederick H Graefe,23850,0,23850
"Feinstein, Dianne",(D),Microsoft Corp,23816,10000,13816
"Feinstein, Dianne",(D),Parsons Corp,23500,23500,0
"Feinstein, Dianne",(D),Business Matters in the Visual Arts,23350,0,23350
"Feinstein, Dianne",(D),Amazon.com,23337,10000,13337
"Feinstein, Dianne",(D),Aetna Inc,22600,0,22600
"Feinstein, Dianne",(D),E&J Gallo Winery,22000,0,22000
"Feinstein, Dianne",(D),Langelier Co,21600,0,21600
"Feinstein, Dianne",(D),Lionsgate,21600,0,21600
"Feinstein, Dianne",(D),Valor Equity Partners,21600,0,21600
"Feinstein, Dianne",(D),National Assn of Broadcasters,21500,21500,0
"Feinstein, Dianne",(D),Blue Cross/Blue Shield,21120,20000,1120
"Feinstein, Dianne",(D),"City & County of San Francisco, CA",21013,0,21013
"Feinstein, Dianne",(D),Facebook Inc,20846,10000,10846
"Feinstein, Dianne",(D),Delta Air Lines,20805,10000,10805
"Feinstein, Dianne",(D),National Assn of Realtors,20500,20000,500
"Feinstein, Dianne",(D),CBRE Group,20260,0,20260
"Feinstein, Dianne",(D),Oaktree Capital Management,20200,0,20200
"Feinstein, Dianne",(D),Raytheon Co,20010,20000,10
"Feinstein, Dianne",(D),AmerisourceBergen Corp,20000,20000,0
"Feinstein, Dianne",(D),Driscoll Berry,20000,0,20000
"Feinstein, Dianne",(D),DISH Network,19900,1000,18900
"Feinstein, Dianne",(D),High Speed Productions,19267,0,19267
"Feinstein, Dianne",(D),Girardi & Keese,19200,0,19200
"Feinstein, Dianne",(D),"Kleiner, Perkins et al",18900,0,18900
"Feinstein, Dianne",(D),US Dept of Justice,18700,0,18700
"Feinstein, Dianne",(D),Citigroup Inc,18590,17000,1590
"Feinstein, Dianne",(D),Covington & Burling,16750,10000,6750
"Feinstein, Dianne",(D),Merck & Co,16500,14500,2000
"Feinstein, Dianne",(D),National Air Traffic Controllers Assn,16500,16500,0
"Feinstein, Dianne",(D),Motion Picture Assn,16400,5500,10900
"Feinstein, Dianne",(D),Charter Communications,16250,16000,250
"Feinstein, Dianne",(D),Allied Wallet,16200,0,16200
"Feinstein, Dianne",(D),Broad Foundation,16200,0,16200
"Feinstein, Dianne",(D),Permira Advisers,16200,0,16200
"Feinstein, Dianne",(D),"Robbins, Geller et al",16200,0,16200
"Feinstein, Dianne",(D),Zacky Farms,16200,0,16200
"Feinstein, Dianne",(D),Boeing Co,16020,15000,1020
"Feinstein, Dianne",(D),Marcus & Millichap,15800,0,15800
"Feinstein, Dianne",(D),Summit Foundation,15800,0,15800
"Feinstein, Dianne",(D),Home Depot,15760,15000,760
"Feinstein, Dianne",(D),American Hospital Assn,15500,15000,500
"Feinstein, Dianne",(D),Invariant LLC,15400,0,15400
"Feinstein, Dianne",(D),Museum of Modern Art,15400,0,15400
"Feinstein, Dianne",(D),Blum Capital Partners,15360,0,15360
"Feinstein, Dianne",(D),Amys Kitchen,15200,0,15200
"Feinstein, Dianne",(D),Broadcom Inc,15008,3700,11308
"Feinstein, Dianne",(D),America's Credit Unions,15000,14000,1000
"Feinstein, Dianne",(D),American Institute of CPAs,15000,15000,0
"Feinstein, Dianne",(D),Sempra Energy,15000,15000,0
"Feinstein, Dianne",(D),Pacific Foods,14600,0,14600
"Feinstein, Dianne",(D),Deloitte LLP,14500,12500,2000
"Feinstein, Dianne",(D),Forbes Tate Partners,14500,0,14500
"Feinstein, Dianne",(D),L3Harris Technologies,14500,14500,0
"Feinstein, Dianne",(D),Visa Inc,14500,14500,0
"Feinstein, Dianne",(D),Van Scoyoc Assoc,14055,4055,10000
"Feinstein, Dianne",(D),Lockheed Martin,14010,13000,1010
"Feinstein, Dianne",(D),Santa Ynez Band of Chumash Indians,14000,0,14000
"Feinstein, Dianne",(D),"Munger, Tolles & Olson",13900,0,13900
"Feinstein, Dianne",(D),Amgen Inc,13695,12500,1195
"Feinstein, Dianne",(D),"Aitken, Aitken & Cohn",13500,0,13500
"Feinstein, Dianne",(D),Clinton Reilly Holdings,13500,0,13500
"Feinstein, Dianne",(D),"Pillsbury, Winthrop et al",13300,0,13300
"Fischer, Deb",(R),Union Pacific Corp,120601,38500,82101
"Fischer, Deb",(R),Northrop Grumman,77575,41000,36575
"Fischer, Deb",(R),Berkshire Hathaway,63650,43000,20650
"Fischer, Deb",(R),AFLAC Inc,60350,32500,27850
"Fischer, Deb",(R),Kiewit Corp,52600,0,52600
"Fischer, Deb",(R),Comcast Corp,52412,36000,16412
"Fischer, Deb",(R),Home Depot,45003,45000,3
"Fischer, Deb",(R),Cox Enterprises,43750,19500,24250
"Fischer, Deb",(R),CSX Corp,43250,37500,5750
"Fischer, Deb",(R),Blue Cross/Blue Shield,42824,34500,8324
"Fischer, Deb",(R),Lockheed Martin,42005,41000,1005
"Fischer, Deb",(R),Tenaska Inc,41400,10500,30900
"Fischer, Deb",(R),NCTA The Internet & Television Assn,41000,40000,1000
"Fischer, Deb",(R),T-Mobile USA,41000,41000,0
"Fischer, Deb",(R),National Multifamily Housing Council,40000,40000,0
"Fischer, Deb",(R),AT&T Inc,38500,37500,1000
"Fischer, Deb",(R),Werner Enterprises,37200,33500,3700
"Fischer, Deb",(R),Delta Air Lines,36310,12500,23810
"Fischer, Deb",(R),American Hotel & Lodging Assn,36000,36000,0
"Fischer, Deb",(R),Honeywell International,35010,35000,10
"Fischer, Deb",(R),Norfolk Southern,35000,35000,0
"Fischer, Deb",(R),Poet LLC,35000,22500,12500
"Fischer, Deb",(R),NelNet Inc,34700,33700,1000
"Fischer, Deb",(R),Deloitte LLP,34275,32500,1775
"Fischer, Deb",(R),Seafarers International Union,31250,31250,0
"Fischer, Deb",(R),HDR Inc,30500,30500,0
"Fischer, Deb",(R),American Trucking Assns,30000,29000,1000
"Fischer, Deb",(R),National Cattlemen's Beef Assn,30000,21000,9000
"Fischer, Deb",(R),Air Line Pilots Assn,29000,29000,0
"Fischer, Deb",(R),Charter Communications,29000,29000,0
"Fischer, Deb",(R),Telephone & Data Systems Inc,29000,29000,0
"Fischer, Deb",(R),General Dynamics,28000,28000,0
"Fischer, Deb",(R),Microsoft Corp,28000,28000,0
"Fischer, Deb",(R),Matson Inc,27950,8000,19950
"Fischer, Deb",(R),United Parcel Service,27500,27500,0
"Fischer, Deb",(R),National Tank Truck Carriers Inc,26000,26000,0
"Fischer, Deb",(R),Old Dominion Freight Line,25500,25500,0
"Fischer, Deb",(R),Elliott Management,25300,0,25300
"Fischer, Deb",(R),Hawkins Construction,25200,0,25200
"Fischer, Deb",(R),Merck & Co,25000,25000,0
"Fischer, Deb",(R),FedEx Corp,24505,24500,5
"Fischer, Deb",(R),Federal Aviation Admin Managers Assn,24500,24500,0
"Fischer, Deb",(R),National Assn of Broadcasters,23500,22500,1000
"Fischer, Deb",(R),RTX Corp,23500,23500,0
"Fischer, Deb",(R),DISH Network,23100,12300,10800
"Fischer, Deb",(R),National Assn of Convenience Stores,22500,22500,0
"Fischer, Deb",(R),Abbott Laboratories,21330,1000,20330
"Fischer, Deb",(R),American Bankers Assn,21000,21000,0
"Fischer, Deb",(R),NTCA/Rural Broadband Assn,20950,20950,0
"Fischer, Deb",(R),NorPAC,20650,0,20650
"Fischer, Deb",(R),Wine & Spirits Wholesalers of America,20500,20500,0
"Fischer, Deb",(R),Growth Energy,20000,20000,0
"Fischer, Deb",(R),National Beer Wholesalers Assn,20000,20000,0
"Fischer, Deb",(R),Pfizer Inc,20000,20000,0
"Fischer, Deb",(R),Republican Majority Fund,20000,20000,0
"Fischer, Deb",(R),Value in Electing Women PAC,20000,20000,0
"Fischer, Deb",(R),Mutual of Omaha,19550,17500,2050
"Fischer, Deb",(R),Home Instead Senior Care,19500,0,19500
"Fischer, Deb",(R),National Rural Electric Cooperative Assn,19500,19500,0
"Fischer, Deb",(R),Owner-Operator Independent Drivers Assn,19500,19500,0
"Fischer, Deb",(R),Schneider National,19500,19500,0
"Fischer, Deb",(R),Southern Co,19500,19500,0
"Fischer, Deb",(R),1st Financial Bank USA,19364,0,19364
"Fischer, Deb",(R),Independent Community Bankers of America,19000,19000,0
"Fischer, Deb",(R),BGR Group,18662,1162,17500
"Fischer, Deb",(R),Lumen Technologies,18505,18500,5
"Fischer, Deb",(R),Dinkel Implement,18500,0,18500
"Fischer, Deb",(R),Huntington Ingalls Industries,18500,18500,0
"Fischer, Deb",(R),Association of Oil Pipe Lines,18400,18400,0
"Fischer, Deb",(R),Nebraska Farm Bureau,18100,16000,2100
"Fischer, Deb",(R),Verizon Communications,18000,17500,500
"Fischer, Deb",(R),General Motors,17625,17000,625
"Fischer, Deb",(R),International Paper,17500,16500,1000
"Fischer, Deb",(R),TC Energy,17500,17500,0
"Fischer, Deb",(R),Kutak Rock LLP,17200,12000,5200
"Fischer, Deb",(R),Eggers Consulting,17050,0,17050
"Fischer, Deb",(R),Husch Blackwell LLP,16975,13500,3475
"Fischer, Deb",(R),Consumer Bankers Assn,16800,16800,0
"Fischer, Deb",(R),Google Inc,16500,16500,0
"Fischer, Deb",(R),National Assn of Realtors,16500,16500,0
"Fischer, Deb",(R),Kirby Corp,16400,11000,5400
"Fischer, Deb",(R),"Hagan, Noll & Boyle",16200,0,16200
"Fischer, Deb",(R),Jane Street Capital,16200,0,16200
"Fischer, Deb",(R),Green Plains,16050,0,16050
"Fischer, Deb",(R),National Pork Producers Council,16000,16000,0
"Fischer, Deb",(R),PricewaterhouseCoopers,16000,15000,1000
"Fischer, Deb",(R),Transportation Intermediaries Assn,16000,16000,0
"Fischer, Deb",(R),CropLife America,15500,15500,0
"Fischer, Deb",(R),Williams & Jensen,15349,2000,13349
"Fischer, Deb",(R),Farmers' Rice Cooperative,15300,14800,500
"Fischer, Deb",(R),Automotive Free International Trade PAC,15000,15000,0
"Fischer, Deb",(R),"Becton, Dickinson & Co",15000,14000,1000
"Fischer, Deb",(R),Crowley Maritime,15000,11000,4000
"Fischer, Deb",(R),Free State PAC,15000,15000,0
"Fischer, Deb",(R),Independent Insurance Agents & Brokers of America,15000,15000,0
"Fischer, Deb",(R),Liquid Energy Pipeline Assn,15000,15000,0
"Fischer, Deb",(R),National Republican Senatorial Cmte,15000,15000,0
"Fischer, Deb",(R),New York Life Insurance,15000,15000,0
"Fischer, Deb",(R),Sinclair Broadcast Group,15000,0,15000
"Fischer, Deb",(R),Walmart Inc,15000,15000,0
"Gillibrand, Kirsten",(D),"Davis, Polk & Wardwell",226605,0,226605
"Gillibrand, Kirsten",(D),"Boies, Schiller & Flexner",222379,0,222379
"Gillibrand, Kirsten",(D),"Paul, Weiss et al",164408,0,164408
"Gillibrand, Kirsten",(D),"Wachtell, Lipton et al",104733,0,104733
"Gillibrand, Kirsten",(D),"Akin, Gump et al",101408,2908,98500
"Gillibrand, Kirsten",(D),Corning Inc,90088,16000,74088
"Gillibrand, Kirsten",(D),Pfizer Inc,85347,15000,70347
"Gillibrand, Kirsten",(D),Sullivan & Cromwell,83433,0,83433
"Gillibrand, Kirsten",(D),Sidley Austin LLP,75847,0,75847
"Gillibrand, Kirsten",(D),"Gibson, Dunn & Crutcher",75582,5000,70582
"Gillibrand, Kirsten",(D),Womencount PAC,74430,5,74425
"Gillibrand, Kirsten",(D),Marsh & McLennan,70160,20000,50160
"Gillibrand, Kirsten",(D),Alphabet Inc,66577,14000,52577
"Gillibrand, Kirsten",(D),Kirkland & Ellis,65159,0,65159
"Gillibrand, Kirsten",(D),Latham & Watkins,61065,0,61065
"Gillibrand, Kirsten",(D),Arnold & Porter Kaye Scholer,60110,5000,55110
"Gillibrand, Kirsten",(D),AT&T Inc,57673,2000,55673
"Gillibrand, Kirsten",(D),HBJ Investments,55700,0,55700
"Gillibrand, Kirsten",(D),New York Life Insurance,53245,20000,33245
"Gillibrand, Kirsten",(D),Carlyle Group,50800,0,50800
"Gillibrand, Kirsten",(D),Emily's List,50131,10000,40131
"Gillibrand, Kirsten",(D),Lazard Ltd,50080,0,50080
"Gillibrand, Kirsten",(D),Estee Lauder Companies,49370,0,49370
"Gillibrand, Kirsten",(D),Blackstone Group,48090,0,48090
"Gillibrand, Kirsten",(D),"Quinn, Emanuel et al",48055,0,48055
"Gillibrand, Kirsten",(D),"Simpson, Thacher & Bartlett",47985,0,47985
"Gillibrand, Kirsten",(D),"Willkie, Farr & Gallagher",47763,0,47763
"Gillibrand, Kirsten",(D),Wirtz Corp,46416,0,46416
"Gillibrand, Kirsten",(D),Morgan Stanley,44743,0,44743
"Gillibrand, Kirsten",(D),Planned Parenthood,44205,5508,38697
"Gillibrand, Kirsten",(D),Bank of America,42813,0,42813
"Gillibrand, Kirsten",(D),UBS AG,39880,20000,19880
"Gillibrand, Kirsten",(D),Milbank LLP,39085,0,39085
"Gillibrand, Kirsten",(D),"Skadden, Arps et al",38958,0,38958
"Gillibrand, Kirsten",(D),Stanford University,38699,0,38699
"Gillibrand, Kirsten",(D),United Talent Agency,37518,0,37518
"Gillibrand, Kirsten",(D),"Kramer, Levin et al",37484,0,37484
"Gillibrand, Kirsten",(D),York Capital Management,37475,0,37475
"Gillibrand, Kirsten",(D),Cooley Llp,36453,0,36453
"Gillibrand, Kirsten",(D),JPMorgan Chase & Co,36169,0,36169
"Gillibrand, Kirsten",(D),Comcast Corp,35991,10000,25991
"Gillibrand, Kirsten",(D),Citigroup Inc,35815,11000,24815
"Gillibrand, Kirsten",(D),Puma Springs Vineyards,35800,0,35800
"Gillibrand, Kirsten",(D),Evercore,35050,0,35050
"Gillibrand, Kirsten",(D),Beach Point Capital Management,35000,0,35000
"Gillibrand, Kirsten",(D),"Fried, Frank et al",34310,0,34310
"Gillibrand, Kirsten",(D),Goldman Sachs,32503,5000,27503
"Gillibrand, Kirsten",(D),ICM Partners,31403,0,31403
"Gillibrand, Kirsten",(D),Columbia University,31152,0,31152
"Gillibrand, Kirsten",(D),Centerbridge Partners,30800,0,30800
"Gillibrand, Kirsten",(D),"City of New York, NY",30735,0,30735
"Gillibrand, Kirsten",(D),Harvard University,30676,0,30676
"Gillibrand, Kirsten",(D),International Brotherhood of Electrical Workers,30281,30000,281
"Gillibrand, Kirsten",(D),BTQ Financial,29150,0,29150
"Gillibrand, Kirsten",(D),Nasdaq Inc,28939,7000,21939
"Gillibrand, Kirsten",(D),State of New York,28680,0,28680
"Gillibrand, Kirsten",(D),Microsoft Corp,28239,7500,20739
"Gillibrand, Kirsten",(D),"Lieff, Cabraser et al",27525,0,27525
"Gillibrand, Kirsten",(D),National Amusements Inc,27489,1000,26489
"Gillibrand, Kirsten",(D),City University of New York,26501,0,26501
"Gillibrand, Kirsten",(D),Warland Investments,26500,0,26500
"Gillibrand, Kirsten",(D),Bill & Melinda Gates Foundation,25450,0,25450
"Gillibrand, Kirsten",(D),American Federation of Teachers,25390,25000,390
"Gillibrand, Kirsten",(D),Magnolia Mae Films,24800,0,24800
"Gillibrand, Kirsten",(D),Capital Group Companies,24505,5000,19505
"Gillibrand, Kirsten",(D),Walt Disney Co,24147,2500,21647
"Gillibrand, Kirsten",(D),New York University,23961,0,23961
"Gillibrand, Kirsten",(D),Debevoise & Plimpton,23715,0,23715
"Gillibrand, Kirsten",(D),Observatory Group,23300,0,23300
"Gillibrand, Kirsten",(D),Altice Usa,23206,5000,18206
"Gillibrand, Kirsten",(D),Barclays,22710,2000,20710
"Gillibrand, Kirsten",(D),Coca-Cola Co,22471,6500,15971
"Gillibrand, Kirsten",(D),Jones Day,22018,0,22018
"Gillibrand, Kirsten",(D),Freshfields Bruckhaus Deringer Llp,21925,0,21925
"Gillibrand, Kirsten",(D),AXA,21895,0,21895
"Gillibrand, Kirsten",(D),Jackson Lewis PC,21703,4000,17703
"Gillibrand, Kirsten",(D),Fisher Brothers,21613,0,21613
"Gillibrand, Kirsten",(D),Cornell University,21206,0,21206
"Gillibrand, Kirsten",(D),Peirson & Patterson,21000,0,21000
"Gillibrand, Kirsten",(D),Susman Godfrey Llp,20450,0,20450
"Gillibrand, Kirsten",(D),Law Offices of Jane C Bergner,20400,0,20400
"Gillibrand, Kirsten",(D),Delaware North Companies,20305,5400,14905
"Gillibrand, Kirsten",(D),Human Rights Watch,20200,0,20200
"Gillibrand, Kirsten",(D),Bertelsmann AG,20086,0,20086
"Gillibrand, Kirsten",(D),Metropolitan Museum of Art,20058,0,20058
"Gillibrand, Kirsten",(D),"Kramer, Dillof et al",20015,0,20015
"Gillibrand, Kirsten",(D),National Assn of Letter Carriers,20008,20000,8
"Gillibrand, Kirsten",(D),National Assn of Real Estate Investment Trusts,20000,20000,0
"Gillibrand, Kirsten",(D),National Multifamily Housing Council,20000,20000,0
"Gillibrand, Kirsten",(D),Kreindler & Kreindler,19900,0,19900
"Gillibrand, Kirsten",(D),Rutgers University,19842,0,19842
"Gillibrand, Kirsten",(D),Massachusetts Mutual Life Insurance,19620,19000,620
"Gillibrand, Kirsten",(D),League of Conservation Voters,19201,11655,7546
"Gillibrand, Kirsten",(D),White & Case,19119,0,19119
"Gillibrand, Kirsten",(D),"Bartlit, Beck et al",19017,0,19017
"Gillibrand, Kirsten",(D),Coming Inc,18985,0,18985
"Gillibrand, Kirsten",(D),"Cravath, Swaine & Moore",18826,0,18826
"Gillibrand, Kirsten",(D),Harnisch Foundation,18550,0,18550
"Gillibrand, Kirsten",(D),KPMG LLP,18435,16000,2435
"Gillibrand, Kirsten",(D),Durst Organization,18200,0,18200
"Graham, Lindsey",(R),Republican Jewish Coalition,110794,8239,102555
"Graham, Lindsey",(R),Lockheed Martin,102450,20000,82450
"Graham, Lindsey",(R),"Nelson, Mullins et al",96609,35000,61609
"Graham, Lindsey",(R),Capital Group Companies,82378,19000,63378
"Graham, Lindsey",(R),Comcast Corp,63978,37500,26478
"Graham, Lindsey",(R),Microsoft Corp,62866,32000,30866
"Graham, Lindsey",(R),Boeing Co,62259,30000,32259
"Graham, Lindsey",(R),Northrop Grumman,60957,41500,19457
"Graham, Lindsey",(R),AT&T Inc,60471,33000,27471
"Graham, Lindsey",(R),Berkshire Hathaway,56832,29500,27332
"Graham, Lindsey",(R),United Parcel Service,56066,35000,21066
"Graham, Lindsey",(R),FedEx Corp,51350,27000,24350
"Graham, Lindsey",(R),Blue Cross/Blue Shield,51024,30000,21024
"Graham, Lindsey",(R),MacAndrews & Forbes,49978,25000,24978
"Graham, Lindsey",(R),US Dept of Defense,49263,0,49263
"Graham, Lindsey",(R),Rdl Inc,48600,0,48600
"Graham, Lindsey",(R),Willoughby & Hoefer,46700,0,46700
"Graham, Lindsey",(R),Bank of America,46389,0,46389
"Graham, Lindsey",(R),Wells Fargo,46033,1000,45033
"Graham, Lindsey",(R),NextEra Energy,45951,1000,44951
"Graham, Lindsey",(R),Woodbranch Investments,45400,0,45400
"Graham, Lindsey",(R),GoldenTree Asset Management,45000,0,45000
"Graham, Lindsey",(R),National Republican Senatorial Cmte,44600,44600,0
"Graham, Lindsey",(R),Altria Group,44068,37500,6568
"Graham, Lindsey",(R),National Assn of Broadcasters,43675,20000,23675
"Graham, Lindsey",(R),Blackstone Group,43055,0,43055
"Graham, Lindsey",(R),US Government,42591,0,42591
"Graham, Lindsey",(R),Sequoia Capital,42200,0,42200
"Graham, Lindsey",(R),CSX Corp,42168,40000,2168
"Graham, Lindsey",(R),HJ Kalikow & Co,42000,0,42000
"Graham, Lindsey",(R),Deloitte LLP,40906,27000,13906
"Graham, Lindsey",(R),Parsons Corp,40185,40000,185
"Graham, Lindsey",(R),Fluor Corp,39625,22000,17625
"Graham, Lindsey",(R),Simms Commercial Development,38900,0,38900
"Graham, Lindsey",(R),Charter Communications,38819,36500,2319
"Graham, Lindsey",(R),Walmart Inc,37946,18500,19446
"Graham, Lindsey",(R),Southern Co,37189,34000,3189
"Graham, Lindsey",(R),General Dynamics,37155,28000,9155
"Graham, Lindsey",(R),Honeywell International,37042,30000,7042
"Graham, Lindsey",(R),American Dental Assn,36750,35000,1750
"Graham, Lindsey",(R),Home Depot,35478,25000,10478
"Graham, Lindsey",(R),Delta Air Lines,35453,10000,25453
"Graham, Lindsey",(R),Oracle Corp,34604,2500,32104
"Graham, Lindsey",(R),IBM Corp,34173,0,34173
"Graham, Lindsey",(R),Union Pacific Corp,34073,33000,1073
"Graham, Lindsey",(R),Verizon Communications,33403,20000,13403
"Graham, Lindsey",(R),US Army,32762,0,32762
"Graham, Lindsey",(R),Pinnacle West Capital,32426,27500,4926
"Graham, Lindsey",(R),Pvs Chemicals,32400,0,32400
"Graham, Lindsey",(R),Walt Disney Co,32296,25000,7296
"Graham, Lindsey",(R),Motley Rice LLC,31288,0,31288
"Graham, Lindsey",(R),Parman Capital Group,31200,0,31200
"Graham, Lindsey",(R),Norfolk Southern,31170,30000,1170
"Graham, Lindsey",(R),US Air Force,30881,0,30881
"Graham, Lindsey",(R),National Assn of Realtors,30553,30000,553
"Graham, Lindsey",(R),Exelon Corp,30436,14000,16436
"Graham, Lindsey",(R),US Postal Service,30055,0,30055
"Graham, Lindsey",(R),American Airlines Group,29201,0,29201
"Graham, Lindsey",(R),McDermott International,28711,27951,760
"Graham, Lindsey",(R),"Brownstein, Hyatt et al",28700,7500,21200
"Graham, Lindsey",(R),JPMorgan Chase & Co,28641,6000,22641
"Graham, Lindsey",(R),Wirtz Corp,27965,0,27965
"Graham, Lindsey",(R),United Airlines Holdings,27606,0,27606
"Graham, Lindsey",(R),JUUL Labs,27400,0,27400
"Graham, Lindsey",(R),Raytheon Technologies,27216,7000,20216
"Graham, Lindsey",(R),Dominion Energy,27201,25000,2201
"Graham, Lindsey",(R),Westrock Capital Partners,27200,0,27200
"Graham, Lindsey",(R),Duke Energy,27141,15000,12141
"Graham, Lindsey",(R),Charles Schwab Corp,26882,0,26882
"Graham, Lindsey",(R),Apollo Global Management,26756,0,26756
"Graham, Lindsey",(R),AFLAC Inc,26568,25000,1568
"Graham, Lindsey",(R),Fierce Government Relations,26500,0,26500
"Graham, Lindsey",(R),Hunt Consolidated,26400,0,26400
"Graham, Lindsey",(R),Unaka Corp,26000,16000,10000
"Graham, Lindsey",(R),Dell Technologies,25947,15000,10947
"Graham, Lindsey",(R),Amazon.com,25932,6000,19932
"Graham, Lindsey",(R),Truist Financial,25905,5000,20905
"Graham, Lindsey",(R),UnitedHealth Group,25867,12500,13367
"Graham, Lindsey",(R),American Hotel & Lodging Assn,25000,25000,0
"Graham, Lindsey",(R),DCI Group,24825,1000,23825
"Graham, Lindsey",(R),RTX Corp,24752,19000,5752
"Graham, Lindsey",(R),US Dept of Veterans Affairs,24667,0,24667
"Graham, Lindsey",(R),Kaiser Permanente,24499,0,24499
"Graham, Lindsey",(R),General Atomics,24469,10000,14469
"Graham, Lindsey",(R),BAE Systems,24383,20000,4383
"Graham, Lindsey",(R),State Farm Insurance,24251,3000,21251
"Graham, Lindsey",(R),Land O'Lakes,23910,8500,15410
"Graham, Lindsey",(R),Fisher Investments,23855,0,23855
"Graham, Lindsey",(R),Texas Children's Hospital,23653,0,23653
"Graham, Lindsey",(R),US Navy,23465,0,23465
"Graham, Lindsey",(R),"Akin, Gump et al",23445,8000,15445
"Graham, Lindsey",(R),General Motors,23419,13500,9919
"Graham, Lindsey",(R),Cerberus Capital Management,23355,16500,6855
"Graham, Lindsey",(R),News Corp,23349,7000,16349
"Graham, Lindsey",(R),State of California,23289,0,23289
"Graham, Lindsey",(R),"Beasley, Allen et al",23000,0,23000
"Graham, Lindsey",(R),McDonald's Corp,22668,2500,20168
"Graham, Lindsey",(R),SAIC,22435,14500,7935
"Graham, Lindsey",(R),International Paper,22225,20000,2225
"Graham, Lindsey",(R),Publix Super Markets,22052,10000,12052
"Grassley, Chuck",(R),Votesane PAC,105500,0,105500
"Grassley, Chuck",(R),Blue Cross/Blue Shield,83400,51750,31650
"Grassley, Chuck",(R),Verizon Communications,59400,38000,21400
"Grassley, Chuck",(R),NextEra Energy,53000,31000,22000
"Grassley, Chuck",(R),Berkshire Hathaway,50275,35000,15275
"Grassley, Chuck",(R),Comcast Corp,49250,30000,19250
"Grassley, Chuck",(R),Blackstone Group,46000,3000,43000
"Grassley, Chuck",(R),Union Pacific Corp,42700,40000,2700
"Grassley, Chuck",(R),Google Inc,40450,31000,9450
"Grassley, Chuck",(R),National Assn of Broadcasters,40000,38000,2000
"Grassley, Chuck",(R),National Assn of Realtors,40000,40000,0
"Grassley, Chuck",(R),National Auto Dealers Assn,40000,40000,0
"Grassley, Chuck",(R),Alston & Bird,37700,8000,29700
"Grassley, Chuck",(R),National Beer Wholesalers Assn,37500,37500,0
"Grassley, Chuck",(R),Renaissance Technologies,36600,0,36600
"Grassley, Chuck",(R),National Assn of Real Estate Investment Trusts,36500,36500,0
"Grassley, Chuck",(R),WilmerHale LLP,36150,0,36150
"Grassley, Chuck",(R),American Hospital Assn,36000,36000,0
"Grassley, Chuck",(R),Sukup Manufacturing,35900,0,35900
"Grassley, Chuck",(R),Honeywell International,35000,35000,0
"Grassley, Chuck",(R),"National Stone, Sand & Gravel Assn",35000,35000,0
"Grassley, Chuck",(R),Prudential Financial,35000,35000,0
"Grassley, Chuck",(R),NASCAR,34700,5000,29700
"Grassley, Chuck",(R),Apollo Global Management,34025,13500,20525
"Grassley, Chuck",(R),DISH Network,33800,10000,23800
"Grassley, Chuck",(R),Iowa Select Farms,32400,0,32400
"Grassley, Chuck",(R),American Podiatric Medical Assn,32250,32000,250
"Grassley, Chuck",(R),Franklin Resources,32100,0,32100
"Grassley, Chuck",(R),Elliott Management,32000,0,32000
"Grassley, Chuck",(R),FedEx Corp,31570,26000,5570
"Grassley, Chuck",(R),AT&T Inc,31020,30500,520
"Grassley, Chuck",(R),Crow Holdings,30600,0,30600
"Grassley, Chuck",(R),American Physical Therapy Assn,30500,30500,0
"Grassley, Chuck",(R),alliantgroup,30350,0,30350
"Grassley, Chuck",(R),AFLAC Inc,30013,30000,13
"Grassley, Chuck",(R),American Hotel & Lodging Assn,30000,30000,0
"Grassley, Chuck",(R),Cardinal Health,30000,30000,0
"Grassley, Chuck",(R),CSX Corp,30000,30000,0
"Grassley, Chuck",(R),National Rural Electric Cooperative Assn,30000,30000,0
"Grassley, Chuck",(R),Lockheed Martin,29540,29500,40
"Grassley, Chuck",(R),Bayer AG,29450,25500,3950
"Grassley, Chuck",(R),King & Spalding,28650,5000,23650
"Grassley, Chuck",(R),NCTA The Internet & Television Assn,28500,28500,0
"Grassley, Chuck",(R),Harbinger Strategies,27650,0,27650
"Grassley, Chuck",(R),Amway/Alticor Inc,27000,0,27000
"Grassley, Chuck",(R),BASF Corp,27000,27000,0
"Grassley, Chuck",(R),National Community Pharmacists Assn,26750,26500,250
"Grassley, Chuck",(R),Capital Group Companies,26400,16000,10400
"Grassley, Chuck",(R),Fresenius Medical Care North America,25000,25000,0
"Grassley, Chuck",(R),Mortgage Bankers Assn,25000,25000,0
"Grassley, Chuck",(R),National Assn of Home Builders,25000,25000,0
"Grassley, Chuck",(R),"Brownstein, Hyatt et al",24700,3500,21200
"Grassley, Chuck",(R),DaVita Inc,24200,13000,11200
"Grassley, Chuck",(R),Meredith Corp,23800,9000,14800
"Grassley, Chuck",(R),Hy-Vee Inc,23725,20000,3725
"Grassley, Chuck",(R),Oberndorf Enterprises,23600,0,23600
"Grassley, Chuck",(R),Altria Group,23525,23500,25
"Grassley, Chuck",(R),Anthem Inc,23500,23500,0
"Grassley, Chuck",(R),American Bankers Assn,22525,22500,25
"Grassley, Chuck",(R),Federation of American Hospitals,22500,22500,0
"Grassley, Chuck",(R),Microsoft Corp,22500,22500,0
"Grassley, Chuck",(R),Wine & Spirits Wholesalers of America,22499,22499,0
"Grassley, Chuck",(R),Wells Fargo,22210,9000,13210
"Grassley, Chuck",(R),Home Depot,22002,22000,2
"Grassley, Chuck",(R),McCoy Group,21900,0,21900
"Grassley, Chuck",(R),Ford Motor Co,21625,19000,2625
"Grassley, Chuck",(R),Amgen Inc,21500,21500,0
"Grassley, Chuck",(R),Poet LLC,21200,14000,7200
"Grassley, Chuck",(R),Uline Inc,21200,0,21200
"Grassley, Chuck",(R),CVS Health,21050,20500,550
"Grassley, Chuck",(R),McKesson Corp,21000,21000,0
"Grassley, Chuck",(R),Bernard Marcus Family Foundation,20800,0,20800
"Grassley, Chuck",(R),Ryan LLC,20600,5000,15600
"Grassley, Chuck",(R),Northrop Grumman,20544,20500,44
"Grassley, Chuck",(R),General Motors,20500,20500,0
"Grassley, Chuck",(R),Bluff Point Assoc,20400,0,20400
"Grassley, Chuck",(R),UnitedHealth Group,20017,20000,17
"Grassley, Chuck",(R),Hilton Worldwide,20001,20000,1
"Grassley, Chuck",(R),American Assn of Nurse Anesthetists,20000,20000,0
"Grassley, Chuck",(R),AmerisourceBergen Corp,20000,20000,0
"Grassley, Chuck",(R),Automotive Free International Trade PAC,20000,20000,0
"Grassley, Chuck",(R),National Multifamily Housing Council,20000,20000,0
"Grassley, Chuck",(R),Promoting Our Republican Team PAC,20000,20000,0
"Grassley, Chuck",(R),Chemorse Ltd,19750,0,19750
"Grassley, Chuck",(R),Lario Oil & Gas,19700,0,19700
"Grassley, Chuck",(R),America's Credit Unions,19500,18000,1500
"Grassley, Chuck",(R),American Chiropractic Assn,19500,19500,0
"Grassley, Chuck",(R),Brownells Inc,19400,0,19400
"Grassley, Chuck",(R),General Electric,19010,19000,10
"Grassley, Chuck",(R),American Medical Assn,19000,17500,1500
"Grassley, Chuck",(R),CUNA Mutual Insurance Society,19000,19000,0
"Grassley, Chuck",(R),Dannenbaum Engineering,18900,0,18900
"Grassley, Chuck",(R),Tiber Creek Group,18800,0,18800
"Grassley, Chuck",(R),WPP plc,18800,2000,16800
"Grassley, Chuck",(R),Centene Corp,18500,13500,5000
"Grassley, Chuck",(R),Humana Inc,18500,18500,0
"Grassley, Chuck",(R),Equity Group Investments,18400,5000,13400
"Grassley, Chuck",(R),Principal Financial Group,18275,13000,5275
"Grassley, Chuck",(R),Walmart Inc,18050,18000,50
"Grassley, Chuck",(R),American Assn of Orthopaedic Surgeons,18000,18000,0
"Hagerty, Bill",(R),Rogers Group,113700,5000,108700
"Hagerty, Bill",(R),Apollo Global Management,108850,25000,83850
"Hagerty, Bill",(R),HCA Inc,86100,15000,71100
"Hagerty, Bill",(R),State of Tennessee,71775,0,71775
"Hagerty, Bill",(R),Fedex Corp,70335,20000,50335
"Hagerty, Bill",(R),Mountain Group Partners,61900,0,61900
"Hagerty, Bill",(R),Asurion LLC,47925,10000,37925
"Hagerty, Bill",(R),CoreCivic Inc,47500,17500,30000
"Hagerty, Bill",(R),Hall Capital (Oklahoma),47100,0,47100
"Hagerty, Bill",(R),Cerberus Capital Management,45800,0,45800
"Hagerty, Bill",(R),National Republican Senatorial Cmte,44600,44600,0
"Hagerty, Bill",(R),Acadia Healthcare,44550,15000,29550
"Hagerty, Bill",(R),Community Health Systems,42800,20000,22800
"Hagerty, Bill",(R),UBS AG,42200,25000,17200
"Hagerty, Bill",(R),Jones Management Services,42100,0,42100
"Hagerty, Bill",(R),International Paper,42000,10000,32000
"Hagerty, Bill",(R),Vanderbilt University,41095,0,41095
"Hagerty, Bill",(R),Blackstone Group,40645,0,40645
"Hagerty, Bill",(R),Goldman Sachs,38700,5000,33700
"Hagerty, Bill",(R),American Investment Council,35600,20000,15600
"Hagerty, Bill",(R),Delek US Holdings,35600,3000,32600
"Hagerty, Bill",(R),AFLAC Inc,35300,15000,20300
"Hagerty, Bill",(R),"Waller, Lansden et al",34700,0,34700
"Hagerty, Bill",(R),Vulcan Materials,33500,20000,13500
"Hagerty, Bill",(R),M&M Industries,32800,0,32800
"Hagerty, Bill",(R),Walbridge Aldinger Co,30000,0,30000
"Hagerty, Bill",(R),Adams & Reese,28800,10000,18800
"Hagerty, Bill",(R),Edward G Lewis PC,27500,0,27500
"Hagerty, Bill",(R),Curb Records,27000,0,27000
"Hagerty, Bill",(R),Collazo Enterprises,26000,0,26000
"Hagerty, Bill",(R),McNabola Law Group,25908,0,25908
"Hagerty, Bill",(R),Toyota Motor Corp,25825,15000,10825
"Hagerty, Bill",(R),Advance Financial,25800,1000,24800
"Hagerty, Bill",(R),National HealthCare Corp,25575,7500,18075
"Hagerty, Bill",(R),Neal & Harwell,25500,0,25500
"Hagerty, Bill",(R),County Cork LLC,24300,0,24300
"Hagerty, Bill",(R),Unum Group,24250,24000,250
"Hagerty, Bill",(R),Eastman Chemical,24100,10000,14100
"Hagerty, Bill",(R),Ingram Industries,24100,7500,16600
"Hagerty, Bill",(R),Tractor Supply Co,24100,12500,11600
"Hagerty, Bill",(R),Thompson Machinery,23800,0,23800
"Hagerty, Bill",(R),Delta Air Lines,23553,17500,6053
"Hagerty, Bill",(R),South College,23100,0,23100
"Hagerty, Bill",(R),FirstBank,23075,0,23075
"Hagerty, Bill",(R),AutoZone Inc,22100,5000,17100
"Hagerty, Bill",(R),Omnivisions Inc,22000,0,22000
"Hagerty, Bill",(R),Protective Life Corp,22000,11000,11000
"Hagerty, Bill",(R),Regions Financial,22000,21000,1000
"Hagerty, Bill",(R),Ernst & Young,21700,10000,11700
"Hagerty, Bill",(R),BGR Group,21200,0,21200
"Hagerty, Bill",(R),Gen Cap America,21200,0,21200
"Hagerty, Bill",(R),Robinhood Markets,21050,2000,19050
"Hagerty, Bill",(R),America's Credit Unions,21000,21000,0
"Hagerty, Bill",(R),Pinnacle Financial Partners,21000,0,21000
"Hagerty, Bill",(R),Volunteer Lumber Sales,21000,0,21000
"Hagerty, Bill",(R),Phillips Infrastructure Holdings,20800,0,20800
"Hagerty, Bill",(R),Community Choice Financial,20750,19500,1250
"Hagerty, Bill",(R),SCF Partners,20600,0,20600
"Hagerty, Bill",(R),General Dynamics,20597,17000,3597
"Hagerty, Bill",(R),Council Capital,20300,0,20300
"Hagerty, Bill",(R),Haury & Smith Contractors,20200,0,20200
"Hagerty, Bill",(R),Stowers Machinery,20150,0,20150
"Hagerty, Bill",(R),Jonathan's Grille,20100,0,20100
"Hagerty, Bill",(R),Home Depot,20088,20000,88
"Hagerty, Bill",(R),Mortgage Bankers Assn,20000,20000,0
"Hagerty, Bill",(R),Rock Holdings,20000,20000,0
"Hagerty, Bill",(R),Southwestern Family of Companies,19900,0,19900
"Hagerty, Bill",(R),UT-Battelle LLC,19750,0,19750
"Hagerty, Bill",(R),QOL Medical,19600,0,19600
"Hagerty, Bill",(R),Jackson National Life Insurance,19500,17500,2000
"Hagerty, Bill",(R),Lackie Trading,19000,0,19000
"Hagerty, Bill",(R),Hollingsworth Companies,18600,0,18600
"Hagerty, Bill",(R),Southern Co,18525,18500,25
"Hagerty, Bill",(R),Lipman Brothers,18500,0,18500
"Hagerty, Bill",(R),Paulson & Co,18050,0,18050
"Hagerty, Bill",(R),KKR & Co,18010,0,18010
"Hagerty, Bill",(R),Oak Ridge National Laboratory,17850,0,17850
"Hagerty, Bill",(R),American Bankers Assn,17750,17500,250
"Hagerty, Bill",(R),"Akin, Gump et al",17700,2500,15200
"Hagerty, Bill",(R),Altria Group,17500,17500,0
"Hagerty, Bill",(R),Rajant Corp,17400,0,17400
"Hagerty, Bill",(R),Signal Hill Management,17400,0,17400
"Hagerty, Bill",(R),"Lewis, Thomason et al",17250,0,17250
"Hagerty, Bill",(R),General Motors,17035,16000,1035
"Hagerty, Bill",(R),Anderson Media (Tennessee),17000,0,17000
"Hagerty, Bill",(R),Hunt Consolidated,17000,0,17000
"Hagerty, Bill",(R),Petra Capital Partners,17000,0,17000
"Hagerty, Bill",(R),McKee Foods,16900,0,16900
"Hagerty, Bill",(R),Fallon Co,16800,0,16800
"Hagerty, Bill",(R),First Atlantic Capital,16800,0,16800
"Hagerty, Bill",(R),Kleinheinz Capital Partners,16800,0,16800
"Hagerty, Bill",(R),Markel Group,16800,0,16800
"Hagerty, Bill",(R),Sequoia Capital,16800,0,16800
"Hagerty, Bill",(R),"Baker, Donelson et al",16600,7100,9500
"Hagerty, Bill",(R),Giarratana LLC,16600,0,16600
"Hagerty, Bill",(R),Dowd & Dowd,16500,0,16500
"Hagerty, Bill",(R),1st Financial Bank USA,16400,0,16400
"Hagerty, Bill",(R),Boyle Investment Co,16350,0,16350
"Hagerty, Bill",(R),John Lee Co,16300,0,16300
"Hagerty, Bill",(R),National Assn of Realtors,16000,16000,0
"Harris, Kamala",(D),Kamala Harris for the People,284967,284967,0
"Harris, Kamala",(D),AT&T Inc,170684,2000,168684
"Harris, Kamala",(D),Walt Disney Co,142946,0,142946
"Harris, Kamala",(D),University of California,133425,0,133425
"Harris, Kamala",(D),Venable LLP,114978,0,114978
"Harris, Kamala",(D),Alphabet Inc,107890,10000,97890
"Harris, Kamala",(D),Creative Artists Agency,97740,0,97740
"Harris, Kamala",(D),"Cotchett, Pitre & McCarthy",83300,0,83300
"Harris, Kamala",(D),"Paul, Weiss et al",76436,0,76436
"Harris, Kamala",(D),Comcast Corp,66910,0,66910
"Harris, Kamala",(D),State of California,62327,0,62327
"Harris, Kamala",(D),Cisco Systems,58136,5000,53136
"Harris, Kamala",(D),Apple Inc,57549,0,57549
"Harris, Kamala",(D),"Akin, Gump et al",57123,2000,55123
"Harris, Kamala",(D),Silver Lake Partners,55741,0,55741
"Harris, Kamala",(D),MacAndrews & Forbes,52310,10000,42310
"Harris, Kamala",(D),American Express,51299,0,51299
"Harris, Kamala",(D),Microsoft Corp,45681,1000,44681
"Harris, Kamala",(D),Lowenstein Sandler Llp,45225,0,45225
"Harris, Kamala",(D),"Gibson, Dunn & Crutcher",44208,5000,39208
"Harris, Kamala",(D),DLA Piper,43299,9000,34299
"Harris, Kamala",(D),Hueston Hennigan Llp,43283,0,43283
"Harris, Kamala",(D),Votesane PAC,41740,0,41740
"Harris, Kamala",(D),"Ziffren, Brittenham et al",41650,0,41650
"Harris, Kamala",(D),National Amusements Inc,40523,0,40523
"Harris, Kamala",(D),"Dreyer, Babich et al",37200,0,37200
"Harris, Kamala",(D),"Robinson, Calcagnie & Robinson",37115,0,37115
"Harris, Kamala",(D),Sony Corp,35655,5000,30655
"Harris, Kamala",(D),Kaiser Permanente,35601,0,35601
"Harris, Kamala",(D),Facebook Inc,35359,0,35359
"Harris, Kamala",(D),Latham & Watkins,35180,0,35180
"Harris, Kamala",(D),Alston & Bird,34728,10000,24728
"Harris, Kamala",(D),University of Southern California,33261,0,33261
"Harris, Kamala",(D),Ziffren Brittenham LLP,33000,0,33000
"Harris, Kamala",(D),Lions Gate Entertainment,32452,0,32452
"Harris, Kamala",(D),Salesforce.com,32378,0,32378
"Harris, Kamala",(D),Amblin Partners,31687,0,31687
"Harris, Kamala",(D),"Lieff, Cabraser et al",30670,0,30670
"Harris, Kamala",(D),"Boies, Schiller & Flexner",29400,0,29400
"Harris, Kamala",(D),Squire Patton Boggs,29335,5000,24335
"Harris, Kamala",(D),Seafarers International Union,29016,28500,516
"Harris, Kamala",(D),Vivendi,28656,3000,25656
"Harris, Kamala",(D),Loeb & Loeb,27850,0,27850
"Harris, Kamala",(D),Kraut Law Group,27150,0,27150
"Harris, Kamala",(D),Bad Robot Productions,27070,0,27070
"Harris, Kamala",(D),Covington & Burling,27055,0,27055
"Harris, Kamala",(D),"Kleiner, Perkins et al",26805,0,26805
"Harris, Kamala",(D),Arnold & Porter Kaye Scholer,26740,5000,21740
"Harris, Kamala",(D),Stanford University,26682,0,26682
"Harris, Kamala",(D),"Keker, Van Nest & Peters",26164,0,26164
"Harris, Kamala",(D),"Robbins, Geller et al",25958,0,25958
"Harris, Kamala",(D),Blue Cross/Blue Shield,25494,10000,15494
"Harris, Kamala",(D),Raj Assoc,25400,0,25400
"Harris, Kamala",(D),"Hansen, Jacobson et al",25350,0,25350
"Harris, Kamala",(D),ME Fox & Co,25300,0,25300
"Harris, Kamala",(D),Carpenters & Joiners Union,25013,25000,13
"Harris, Kamala",(D),Plumbers/Pipefitters Union,25000,25000,0
"Harris, Kamala",(D),Emily's List,24069,10000,14069
"Harris, Kamala",(D),Irell & Manella,23516,0,23516
"Harris, Kamala",(D),United Food & Commercial Workers Union,22493,10000,12493
"Harris, Kamala",(D),"Skadden, Arps et al",22298,0,22298
"Harris, Kamala",(D),"Greene, Broillet et al",22213,0,22213
"Harris, Kamala",(D),Hk Motors,21600,0,21600
"Harris, Kamala",(D),Huneeus Winery,21600,0,21600
"Harris, Kamala",(D),"Panish, Shea & Boyle",21600,0,21600
"Harris, Kamala",(D),Morgan Stanley,21467,0,21467
"Harris, Kamala",(D),Holland & Knight,21412,2500,18912
"Harris, Kamala",(D),Puma Springs Vineyards,21300,0,21300
"Harris, Kamala",(D),Harbor Freight Tools,21205,0,21205
"Harris, Kamala",(D),United Talent Agency,21104,0,21104
"Harris, Kamala",(D),ArentFox Schiff,20850,1000,19850
"Harris, Kamala",(D),Santa Ynez Band of Chumash Indians,20822,0,20822
"Harris, Kamala",(D),Nossaman LLP,20622,6500,14122
"Harris, Kamala",(D),Charles Schwab Corp,19923,0,19923
"Harris, Kamala",(D),Advance Publications,19759,0,19759
"Harris, Kamala",(D),Harvard University,19725,0,19725
"Harris, Kamala",(D),Womencount PAC,19711,5,19706
"Harris, Kamala",(D),Yucaipa Companies,19700,0,19700
"Harris, Kamala",(D),Reed Smith LLP,19291,1500,17791
"Harris, Kamala",(D),Aeris Communications,19100,0,19100
"Harris, Kamala",(D),"Orrick, Herrington & Sutcliffe",18926,5600,13326
"Harris, Kamala",(D),Emerald Fund,18900,0,18900
"Harris, Kamala",(D),Lazard Ltd,18513,0,18513
"Harris, Kamala",(D),Perkins Investment Management,18400,0,18400
"Harris, Kamala",(D),Jewish Family & Children's Services,18350,0,18350
"Harris, Kamala",(D),"Manatt, Phelps & Phillips",18183,0,18183
"Harris, Kamala",(D),Renaissance Technologies,18138,0,18138
"Harris, Kamala",(D),Outfront Media,17584,0,17584
"Harris, Kamala",(D),Citigroup Inc,17205,0,17205
"Harris, Kamala",(D),"Coblentz, Patch et al",16850,0,16850
"Harris, Kamala",(D),San Francisco Day School,16850,0,16850
"Harris, Kamala",(D),"Pillsbury, Winthrop et al",16823,0,16823
"Harris, Kamala",(D),National Education Assn,16769,15000,1769
"Harris, Kamala",(D),"City & County of San Francisco, CA",16410,0,16410
"Harris, Kamala",(D),New Enterprise Assoc,16400,0,16400
"Harris, Kamala",(D),International Brotherhood of Electrical Workers,16325,15000,1325
"Harris, Kamala",(D),Pisces Inc,16310,0,16310
"Harris, Kamala",(D),Route One Investment,16200,0,16200
"Harris, Kamala",(D),Wells Fargo,16176,0,16176
"Harris, Kamala",(D),"Walkup, Melodia et al",16150,0,16150
"Hassan, Maggie",(D),Emily's List,562309,10000,552309
"Hassan, Maggie",(D),JStreetPAC,208551,0,208551
"Hassan, Maggie",(D),Harvard University,109493,0,109493
"Hassan, Maggie",(D),Dartmouth College,76994,0,76994
"Hassan, Maggie",(D),Council for a Livable World,64898,1000,63898
"Hassan, Maggie",(D),"Paul, Weiss et al",63030,0,63030
"Hassan, Maggie",(D),University of New Hampshire,52640,0,52640
"Hassan, Maggie",(D),University of California,51953,0,51953
"Hassan, Maggie",(D),Alphabet Inc,46495,5000,41495
"Hassan, Maggie",(D),Massachusetts Institute of Technology,44364,0,44364
"Hassan, Maggie",(D),Fidelity Investments,43355,26000,17355
"Hassan, Maggie",(D),Motley Rice LLC,43053,0,43053
"Hassan, Maggie",(D),Democratic Senatorial Campaign Cmte,41800,41800,0
"Hassan, Maggie",(D),Voices for Progress,41139,889,40250
"Hassan, Maggie",(D),State of New Hampshire,40723,0,40723
"Hassan, Maggie",(D),Thornton Law Firm,38700,0,38700
"Hassan, Maggie",(D),AT&T Inc,38262,17000,21262
"Hassan, Maggie",(D),Susman Godfrey Llp,36200,0,36200
"Hassan, Maggie",(D),WilmerHale LLP,35645,0,35645
"Hassan, Maggie",(D),Microsoft Corp,34586,19000,15586
"Hassan, Maggie",(D),Blue Cross/Blue Shield,33299,9000,24299
"Hassan, Maggie",(D),Comcast Corp,33283,22500,10783
"Hassan, Maggie",(D),"Mintz, Levin et al",32700,0,32700
"Hassan, Maggie",(D),Womencount PAC,32268,0,32268
"Hassan, Maggie",(D),Laborers Union,30517,30500,17
"Hassan, Maggie",(D),Dartmouth-Hitchcock Medical Center,28402,0,28402
"Hassan, Maggie",(D),Beacon Companies,28250,0,28250
"Hassan, Maggie",(D),"Akin, Gump et al",27986,0,27986
"Hassan, Maggie",(D),"Sheet Metal, Air, Rail & Transportation Union",27500,27500,0
"Hassan, Maggie",(D),University of Pennsylvania,27226,0,27226
"Hassan, Maggie",(D),Columbia University,27136,0,27136
"Hassan, Maggie",(D),Stanford University,26886,0,26886
"Hassan, Maggie",(D),Aloha Partners,26600,0,26600
"Hassan, Maggie",(D),Goldman Sachs,26233,20000,6233
"Hassan, Maggie",(D),Dell Technologies,26209,21000,5209
"Hassan, Maggie",(D),American Assn for Justice,25450,23500,1950
"Hassan, Maggie",(D),Barbara Lee Family Foundation,25400,0,25400
"Hassan, Maggie",(D),Anheuser-Busch,25250,25000,250
"Hassan, Maggie",(D),International Brotherhood of Electrical Workers,25095,25000,95
"Hassan, Maggie",(D),BAE Systems,24598,22500,2098
"Hassan, Maggie",(D),"Abramson, Brown & Dugan",23732,0,23732
"Hassan, Maggie",(D),New York Life Insurance,22540,13000,9540
"Hassan, Maggie",(D),National Beer Wholesalers Assn,22500,22500,0
"Hassan, Maggie",(D),Mass General Brigham,22373,0,22373
"Hassan, Maggie",(D),Plymouth Rock Co,22300,0,22300
"Hassan, Maggie",(D),Deloitte LLP,21930,20000,1930
"Hassan, Maggie",(D),Service Employees International Union,21918,15000,6918
"Hassan, Maggie",(D),Honeywell International,21346,21000,346
"Hassan, Maggie",(D),WPP plc,20633,0,20633
"Hassan, Maggie",(D),National Air Traffic Controllers Assn,20500,20500,0
"Hassan, Maggie",(D),Boston University,20310,0,20310
"Hassan, Maggie",(D),Planned Parenthood,20176,9999,10177
"Hassan, Maggie",(D),Capital Group Companies,20032,20000,32
"Hassan, Maggie",(D),UBS AG,20006,20000,6
"Hassan, Maggie",(D),A New Direction PAC,20000,20000,0
"Hassan, Maggie",(D),Common Ground PAC,20000,20000,0
"Hassan, Maggie",(D),Great Lakes PAC,20000,20000,0
"Hassan, Maggie",(D),Impact (Schumer),20000,20000,0
"Hassan, Maggie",(D),Motor City PAC,20000,20000,0
"Hassan, Maggie",(D),Nutmeg PAC,20000,20000,0
"Hassan, Maggie",(D),Off the Sidelines,20000,20000,0
"Hassan, Maggie",(D),Purpose PAC,20000,20000,0
"Hassan, Maggie",(D),Treasure State PAC,20000,20000,0
"Hassan, Maggie",(D),City University of New York,19906,0,19906
"Hassan, Maggie",(D),Yale University,19713,0,19713
"Hassan, Maggie",(D),Northeastern University,19632,0,19632
"Hassan, Maggie",(D),Cozen O'Connor,19600,3000,16600
"Hassan, Maggie",(D),Northrop Grumman,19312,17500,1812
"Hassan, Maggie",(D),Pfizer Inc,19035,10000,9035
"Hassan, Maggie",(D),UnitedHealth Group,18935,16000,2935
"Hassan, Maggie",(D),Renaissance Technologies,18900,0,18900
"Hassan, Maggie",(D),Commonwealth of Massachusetts,18839,0,18839
"Hassan, Maggie",(D),Walt Disney Co,18320,0,18320
"Hassan, Maggie",(D),Foley Hoag LLP,18076,0,18076
"Hassan, Maggie",(D),IBM Corp,17914,0,17914
"Hassan, Maggie",(D),Centene Corp,17613,10000,7613
"Hassan, Maggie",(D),Charter Communications,17597,17500,97
"Hassan, Maggie",(D),Hawaii PAC,17500,17500,0
"Hassan, Maggie",(D),Mortgage Bankers Assn,17500,17500,0
"Hassan, Maggie",(D),NCTA The Internet & Television Assn,17500,17500,0
"Hassan, Maggie",(D),"Newmark, Grubb et al",17200,0,17200
"Hassan, Maggie",(D),State of California,16927,0,16927
"Hassan, Maggie",(D),Ropes & Gray,16625,0,16625
"Hassan, Maggie",(D),Intel Corp,16600,12000,4600
"Hassan, Maggie",(D),Artery Capital Group,16200,0,16200
"Hassan, Maggie",(D),Castagna Realty,16200,0,16200
"Hassan, Maggie",(D),Girardi & Keese,16200,0,16200
"Hassan, Maggie",(D),Global Partners LP,16200,0,16200
"Hassan, Maggie",(D),Save Our Heritage,16200,0,16200
"Hassan, Maggie",(D),US Government,16162,0,16162
"Hassan, Maggie",(D),NARAL Pro-Choice America,16100,10000,6100
"Hassan, Maggie",(D),"Hirsch, Roberts & Weinstein",16065,0,16065
"Hassan, Maggie",(D),True Love Productions,16000,0,16000
"Hassan, Maggie",(D),United Parcel Service,15943,14500,1443
"Hassan, Maggie",(D),Genworth Financial,15650,0,15650
"Hassan, Maggie",(D),Bluewater Partners,15600,0,15600
"Hassan, Maggie",(D),"Skadden, Arps et al",15585,0,15585
"Hassan, Maggie",(D),JPMorgan Chase & Co,15218,5000,10218
"Hassan, Maggie",(D),Verizon Communications,15174,11000,4174
"Hassan, Maggie",(D),Ameresco Inc,15159,0,15159
"Hawley, Josh",(R),Club for Growth,299301,0,299301
"Hawley, Josh",(R),Senate Conservatives Fund,257589,5000,252589
"Hawley, Josh",(R),Diamond Pet Foods,70900,0,70900
"Hawley, Josh",(R),Emerson Electric,52500,15000,37500
"Hawley, Josh",(R),National Republican Senatorial Cmte,47400,47400,0
"Hawley, Josh",(R),Herzog,46050,5000,41050
"Hawley, Josh",(R),Hunter Engineering,44000,0,44000
"Hawley, Josh",(R),Charles Schwab Corp,38725,0,38725
"Hawley, Josh",(R),Edward Jones,38085,3500,34585
"Hawley, Josh",(R),Alliance Coal,33466,10000,23466
"Hawley, Josh",(R),Orscheln Group,32800,0,32800
"Hawley, Josh",(R),Kirkland & Ellis,30428,0,30428
"Hawley, Josh",(R),Herschend Family Entertainment,29100,0,29100
"Hawley, Josh",(R),Marathon Petroleum,27500,27500,0
"Hawley, Josh",(R),Ozarks Coca-Cola Bottling,27400,0,27400
"Hawley, Josh",(R),Bayer AG,27050,5000,22050
"Hawley, Josh",(R),Leggett & Platt,26000,10000,16000
"Hawley, Josh",(R),Durham Co,25700,0,25700
"Hawley, Josh",(R),Charter Communications,23605,15000,8605
"Hawley, Josh",(R),Susan B Anthony List,23594,1200,22394
"Hawley, Josh",(R),Berkshire Hathaway,23300,10000,13300
"Hawley, Josh",(R),Cigna Corp,22302,2500,19802
"Hawley, Josh",(R),Wells Fargo,22220,2500,19720
"Hawley, Josh",(R),Bodley Group,22000,0,22000
"Hawley, Josh",(R),Russell Stover Candies,22000,0,22000
"Hawley, Josh",(R),Midway Usa,21800,0,21800
"Hawley, Josh",(R),AT&T Inc,21615,4000,17615
"Hawley, Josh",(R),Immvac Inc,21600,0,21600
"Hawley, Josh",(R),Jennmar Corp,21600,0,21600
"Hawley, Josh",(R),Loren Cook Co,21600,0,21600
"Hawley, Josh",(R),Willard Asphalt Paving,21600,0,21600
"Hawley, Josh",(R),"Bryan, Cave et al",20868,5500,15368
"Hawley, Josh",(R),Thompson Coburn LLP,20500,12000,8500
"Hawley, Josh",(R),Ascension Health,20300,0,20300
"Hawley, Josh",(R),H&R Block,20170,20000,170
"Hawley, Josh",(R),Mahaffey Enterprises,20100,0,20100
"Hawley, Josh",(R),Republican Jewish Coalition,19625,10000,9625
"Hawley, Josh",(R),Comcast Corp,19049,15000,4049
"Hawley, Josh",(R),Dot Foods,18900,0,18900
"Hawley, Josh",(R),Jes Holdings LLC,18900,0,18900
"Hawley, Josh",(R),Kit Bond Strategies,18750,0,18750
"Hawley, Josh",(R),Prime Inc,18700,0,18700
"Hawley, Josh",(R),Acadia Healthcare,18100,4500,13600
"Hawley, Josh",(R),Tlc Properties,17850,0,17850
"Hawley, Josh",(R),Schnuck Markets,17325,0,17325
"Hawley, Josh",(R),Fierce Government Relations,17200,0,17200
"Hawley, Josh",(R),Hallmark Cards,17019,12000,5019
"Hawley, Josh",(R),Washington University in St Louis,16876,0,16876
"Hawley, Josh",(R),Williams Companies,16800,5000,11800
"Hawley, Josh",(R),Drury Hotels,16450,0,16450
"Hawley, Josh",(R),Concordance Academy,16400,0,16400
"Hawley, Josh",(R),National Assn of Broadcasters,16400,5000,11400
"Hawley, Josh",(R),Bartlett Grain,16200,0,16200
"Hawley, Josh",(R),Drury Dev,16200,0,16200
"Hawley, Josh",(R),Farmer Co,16200,0,16200
"Hawley, Josh",(R),TAMKO Building Products,16200,0,16200
"Hawley, Josh",(R),"Cohen, Klingenstein & Marks",16100,0,16100
"Hawley, Josh",(R),Deloitte LLP,15653,15000,653
"Hawley, Josh",(R),Station Casinos,15600,0,15600
"Hawley, Josh",(R),Northrop Grumman,15235,10000,5235
"Hawley, Josh",(R),Asian American Hotel Owners Assn,15000,15000,0
"Hawley, Josh",(R),Mercy,14925,0,14925
"Hawley, Josh",(R),Ameren Corp,14865,9000,5865
"Hawley, Josh",(R),Baur Properties,14800,0,14800
"Hawley, Josh",(R),Boeing Co,14761,0,14761
"Hawley, Josh",(R),Proskauer Rose,14500,0,14500
"Hawley, Josh",(R),Mills Properties,14350,0,14350
"Hawley, Josh",(R),Clawson Farms,14200,0,14200
"Hawley, Josh",(R),Country Club Bank,13900,0,13900
"Hawley, Josh",(R),Harbinger Strategies,13800,0,13800
"Hawley, Josh",(R),Chevron Corp,13705,10000,3705
"Hawley, Josh",(R),O'Reilly Auto Parts,13700,0,13700
"Hawley, Josh",(R),Src Holdings,13700,0,13700
"Hawley, Josh",(R),Centene Corp,13600,0,13600
"Hawley, Josh",(R),Federal Protection Inc,13600,0,13600
"Hawley, Josh",(R),JE Dunn Construction Group,13600,0,13600
"Hawley, Josh",(R),American Bankers Assn,13525,12500,1025
"Hawley, Josh",(R),International Franchise Assn,13500,13500,0
"Hawley, Josh",(R),Northwestern Mutual,13450,0,13450
"Hawley, Josh",(R),Lathrop & Gage,13200,5000,8200
"Hawley, Josh",(R),Polsinelli Pc,13200,0,13200
"Hawley, Josh",(R),GJ Grewe Inc,13100,0,13100
"Hawley, Josh",(R),Veterans United Home Loans,13100,0,13100
"Hawley, Josh",(R),University of Missouri,12920,0,12920
"Hawley, Josh",(R),UnitedHealth Group,12763,10000,2763
"Hawley, Josh",(R),Altria Group,12700,10000,2700
"Hawley, Josh",(R),Bristol Manufacturing,12700,0,12700
"Hawley, Josh",(R),Cerner Corp,12620,10000,2620
"Hawley, Josh",(R),Asplundh Tree Expert Co,12500,10000,2500
"Hawley, Josh",(R),General Motors,11800,8500,3300
"Hawley, Josh",(R),Show Me Institute,11800,0,11800
"Hawley, Josh",(R),Starline Inc,11800,0,11800
"Hawley, Josh",(R),Husch Blackwell LLP,11400,4500,6900
"Hawley, Josh",(R),Cepia,11200,0,11200
"Hawley, Josh",(R),Bsi Constructors,11100,0,11100
"Hawley, Josh",(R),Accenture,11025,0,11025
"Hawley, Josh",(R),Civic Service Inc,11000,0,11000
"Hawley, Josh",(R),HTH Companies,11000,0,11000
"Hawley, Josh",(R),Interactive Brokers,11000,0,11000
"Hawley, Josh",(R),Koch Industries,11000,10000,1000
"Heinrich, Martin",(D),League of Conservation Voters,124304,16979,107325
"Heinrich, Martin",(D),MMR Group,73400,0,73400
"Heinrich, Martin",(D),University of New Mexico,62144,0,62144
"Heinrich, Martin",(D),JStreetPAC,62067,0,62067
"Heinrich, Martin",(D),NextEra Energy,55510,29500,26010
"Heinrich, Martin",(D),Cigna Corp,55000,45000,10000
"Heinrich, Martin",(D),Northrop Grumman,50510,50500,10
"Heinrich, Martin",(D),Honeywell International,50416,37500,12916
"Heinrich, Martin",(D),American Health Care Assn,49900,41000,8900
"Heinrich, Martin",(D),International Brotherhood of Electrical Workers,44209,44000,209
"Heinrich, Martin",(D),DaVita Inc,43000,35500,7500
"Heinrich, Martin",(D),Berkshire Hathaway,42900,39500,3400
"Heinrich, Martin",(D),American Assn for Justice,41000,41000,0
"Heinrich, Martin",(D),Alphabet Inc,40728,30500,10228
"Heinrich, Martin",(D),Hewlett Packard Enterprise,40279,40000,279
"Heinrich, Martin",(D),Air Line Pilots Assn,40000,40000,0
"Heinrich, Martin",(D),Laborers Union,40000,40000,0
"Heinrich, Martin",(D),UBS Americas,40000,40000,0
"Heinrich, Martin",(D),"Akin, Gump et al",39452,3750,35702
"Heinrich, Martin",(D),General Atomics,38700,19000,19700
"Heinrich, Martin",(D),Poarch Band of Creek Indians,38100,0,38100
"Heinrich, Martin",(D),RTX Corp,37510,36500,1010
"Heinrich, Martin",(D),PricewaterhouseCoopers,37500,37500,0
"Heinrich, Martin",(D),Pfizer Inc,36500,36500,0
"Heinrich, Martin",(D),Home Depot,36097,35000,1097
"Heinrich, Martin",(D),Union Pacific Corp,35005,35000,5
"Heinrich, Martin",(D),National Assn of Letter Carriers,34000,34000,0
"Heinrich, Martin",(D),"Robbins, Geller et al",32500,0,32500
"Heinrich, Martin",(D),Microsoft Corp,31600,30000,1600
"Heinrich, Martin",(D),Lockheed Martin,31211,28500,2711
"Heinrich, Martin",(D),Comcast Corp,30509,26000,4509
"Heinrich, Martin",(D),Council of Insurance Agents & Brokers,30000,30000,0
"Heinrich, Martin",(D),Merck & Co,30000,30000,0
"Heinrich, Martin",(D),National Air Traffic Controllers Assn,30000,30000,0
"Heinrich, Martin",(D),National Multifamily Housing Council,30000,30000,0
"Heinrich, Martin",(D),Intel Corp,29945,27000,2945
"Heinrich, Martin",(D),Carpenters & Joiners Union,29500,29500,0
"Heinrich, Martin",(D),New York Life Insurance,29340,26500,2840
"Heinrich, Martin",(D),Cherokee Nation,29200,0,29200
"Heinrich, Martin",(D),NelNet Inc,29000,29000,0
"Heinrich, Martin",(D),Blackstone Group,27000,0,27000
"Heinrich, Martin",(D),AT&T Inc,26560,17500,9060
"Heinrich, Martin",(D),Blue Cross/Blue Shield,26560,25500,1060
"Heinrich, Martin",(D),Tellurian Inc,26500,9000,17500
"Heinrich, Martin",(D),Huntington Ingalls Industries,26000,26000,0
"Heinrich, Martin",(D),Cornerstone Government Affairs,25950,0,25950
"Heinrich, Martin",(D),Chickasaw Nation,25400,0,25400
"Heinrich, Martin",(D),Capital Group Companies,25000,25000,0
"Heinrich, Martin",(D),KPMG LLP,25000,25000,0
"Heinrich, Martin",(D),National Beer Wholesalers Assn,25000,25000,0
"Heinrich, Martin",(D),UNITE HERE,25000,25000,0
"Heinrich, Martin",(D),Facebook Inc,24700,17500,7200
"Heinrich, Martin",(D),Gila River Indian Community,24700,0,24700
"Heinrich, Martin",(D),"Sheet Metal, Air, Rail & Transportation Union",24500,24500,0
"Heinrich, Martin",(D),Poet LLC,24000,24000,0
"Heinrich, Martin",(D),"Brownstein, Hyatt et al",23750,8000,15750
"Heinrich, Martin",(D),American Optometric Assn,23250,23000,250
"Heinrich, Martin",(D),iHeartMedia Inc,23000,23000,0
"Heinrich, Martin",(D),National Assn of Broadcasters,22750,20500,2250
"Heinrich, Martin",(D),Genentech Inc,22505,22500,5
"Heinrich, Martin",(D),Burns & McDonnell,22500,22500,0
"Heinrich, Martin",(D),Tunica-Biloxi Tribe of Louisiana,22400,0,22400
"Heinrich, Martin",(D),Forbes Tate Partners,20700,0,20700
"Heinrich, Martin",(D),Independent Community Bankers of America,20500,20500,0
"Heinrich, Martin",(D),National Rural Letter Carriers Assn,20500,20500,0
"Heinrich, Martin",(D),Sempra Energy,20500,20500,0
"Heinrich, Martin",(D),Southern Co,20500,20500,0
"Heinrich, Martin",(D),Alston & Bird,20250,17500,2750
"Heinrich, Martin",(D),Tpp Export America,20200,0,20200
"Heinrich, Martin",(D),American Bankers Assn,20000,20000,0
"Heinrich, Martin",(D),Korein Tillery LLC,20000,0,20000
"Heinrich, Martin",(D),National Assn of Health Underwriters,20000,20000,0
"Heinrich, Martin",(D),Plumbers/Pipefitters Union,20000,20000,0
"Heinrich, Martin",(D),National Assn of Realtors,19990,19990,0
"Heinrich, Martin",(D),UnitedHealth Group,19890,18500,1390
"Heinrich, Martin",(D),Leidos Inc,19425,19000,425
"Heinrich, Martin",(D),WPP plc,19250,0,19250
"Heinrich, Martin",(D),314 Action Fund,19000,19000,0
"Heinrich, Martin",(D),Doterra International,19000,0,19000
"Heinrich, Martin",(D),Apollo Global Management,18800,5000,13800
"Heinrich, Martin",(D),United Parcel Service,18575,18500,75
"Heinrich, Martin",(D),Humana Inc,18525,18500,25
"Heinrich, Martin",(D),L&F Distributors,18500,0,18500
"Heinrich, Martin",(D),Democracy Engine,18100,0,18100
"Heinrich, Martin",(D),American Institute of CPAs,18000,18000,0
"Heinrich, Martin",(D),National Indian Gaming Assn,18000,15500,2500
"Heinrich, Martin",(D),NCTA The Internet & Television Assn,18000,18000,0
"Heinrich, Martin",(D),Silver Lake Partners,17700,2700,15000
"Heinrich, Martin",(D),American Crystal Sugar,17500,17500,0
"Heinrich, Martin",(D),ITC Holdings,17500,17500,0
"Heinrich, Martin",(D),Pechanga Band of Luiseno Mission Indians,17500,0,17500
"Heinrich, Martin",(D),PG&E Corp,17100,11000,6100
"Heinrich, Martin",(D),AFLAC Inc,17000,17000,0
"Heinrich, Martin",(D),Gulf States Toyota,16500,14000,2500
"Heinrich, Martin",(D),Discovery Inc,16200,0,16200
"Heinrich, Martin",(D),Credit Union National Assn,16000,16000,0
"Heinrich, Martin",(D),Hugo Neu Corp,16000,0,16000
"Heinrich, Martin",(D),Horning Brothers,15900,0,15900
"Heinrich, Martin",(D),Sunrun Inc,15750,10500,5250
"Heinrich, Martin",(D),American Federation of State/Cnty/Munic Employees,15500,15000,500
"Hickenlooper, John",(D),Alphabet Inc,261141,0,261141
"Hickenlooper, John",(D),Democracy Engine,241066,0,241066
"Hickenlooper, John",(D),University of Colorado,203194,0,203194
"Hickenlooper, John",(D),University of California,179272,0,179272
"Hickenlooper, John",(D),J Street,159910,85,159825
"Hickenlooper, John",(D),Hickenlooper 2020,129235,128705,530
"Hickenlooper, John",(D),Microsoft Corp,127828,0,127828
"Hickenlooper, John",(D),Harvard University,107955,0,107955
"Hickenlooper, John",(D),Amazon.com,80815,0,80815
"Hickenlooper, John",(D),Apple Inc,78499,0,78499
"Hickenlooper, John",(D),Liberty Media Corp,77812,0,77812
"Hickenlooper, John",(D),"Brownstein, Hyatt et al",71836,0,71836
"Hickenlooper, John",(D),US Government,68601,0,68601
"Hickenlooper, John",(D),Comcast Corp,68329,0,68329
"Hickenlooper, John",(D),State of Colorado,67845,0,67845
"Hickenlooper, John",(D),Meta,65028,0,65028
"Hickenlooper, John",(D),Kaiser Permanente,63888,0,63888
"Hickenlooper, John",(D),Stanford University,62616,0,62616
"Hickenlooper, John",(D),Walt Disney Co,60935,0,60935
"Hickenlooper, John",(D),IBM Corp,56001,0,56001
"Hickenlooper, John",(D),Democratic Senatorial Campaign Cmte,49600,49600,0
"Hickenlooper, John",(D),314 Action,48151,23000,25151
"Hickenlooper, John",(D),Colorado State University,43858,0,43858
"Hickenlooper, John",(D),Oracle Corp,43703,0,43703
"Hickenlooper, John",(D),Insight Partners,43656,0,43656
"Hickenlooper, John",(D),WilmerHale Llp,43425,0,43425
"Hickenlooper, John",(D),Columbia University,42893,0,42893
"Hickenlooper, John",(D),Monroe Group (Colorado),42850,0,42850
"Hickenlooper, John",(D),State of California,41418,0,41418
"Hickenlooper, John",(D),University of Washington,39731,0,39731
"Hickenlooper, John",(D),Massachusetts Institute of Technology,39724,0,39724
"Hickenlooper, John",(D),Gart Companies,39400,0,39400
"Hickenlooper, John",(D),University of Denver,39277,0,39277
"Hickenlooper, John",(D),Wonderful Co,37499,0,37499
"Hickenlooper, John",(D),Latham & Watkins,36139,0,36139
"Hickenlooper, John",(D),Warner Brothers Discovery,35586,0,35586
"Hickenlooper, John",(D),Motley Rice LLC,35394,0,35394
"Hickenlooper, John",(D),Vail Resorts,35263,0,35263
"Hickenlooper, John",(D),Mass General Brigham,34053,0,34053
"Hickenlooper, John",(D),New York University,34014,0,34014
"Hickenlooper, John",(D),Wells Fargo,33692,0,33692
"Hickenlooper, John",(D),"City of New York, NY",33429,0,33429
"Hickenlooper, John",(D),UnitedHealth Group,33070,0,33070
"Hickenlooper, John",(D),National Amusements Inc,32959,0,32959
"Hickenlooper, John",(D),US Dept of the Interior,32324,0,32324
"Hickenlooper, John",(D),University of Pennsylvania,32240,0,32240
"Hickenlooper, John",(D),Hogan Lovells,32118,0,32118
"Hickenlooper, John",(D),East West Partners,31500,0,31500
"Hickenlooper, John",(D),Bain Capital,31300,0,31300
"Hickenlooper, John",(D),Yale University,30798,0,30798
"Hickenlooper, John",(D),Xcel Energy,29969,0,29969
"Hickenlooper, John",(D),Salesforce.com,29679,0,29679
"Hickenlooper, John",(D),US Dept of Health & Human Services,29514,0,29514
"Hickenlooper, John",(D),"Akin, Gump et al",29132,0,29132
"Hickenlooper, John",(D),McKinsey & Co,28895,0,28895
"Hickenlooper, John",(D),Renaissance Technologies,28790,0,28790
"Hickenlooper, John",(D),Cisco Systems,28348,0,28348
"Hickenlooper, John",(D),Winston & Strawn,28307,0,28307
"Hickenlooper, John",(D),Miller Global Properties,28000,0,28000
"Hickenlooper, John",(D),Route One Investment,28000,0,28000
"Hickenlooper, John",(D),Fullerton Investors,27400,0,27400
"Hickenlooper, John",(D),Centerview Partners,27352,0,27352
"Hickenlooper, John",(D),AT&T Inc,27122,0,27122
"Hickenlooper, John",(D),Adobe Inc,26886,0,26886
"Hickenlooper, John",(D),Kirkland & Ellis,26848,0,26848
"Hickenlooper, John",(D),Breckenridge-Wynkoop LLC,26800,0,26800
"Hickenlooper, John",(D),Goldman Sachs,26447,0,26447
"Hickenlooper, John",(D),University of Southern California,26094,0,26094
"Hickenlooper, John",(D),Fidelity National Information Services,25821,0,25821
"Hickenlooper, John",(D),Boeing Co,25752,0,25752
"Hickenlooper, John",(D),Liberty Global,25206,0,25206
"Hickenlooper, John",(D),US Dept of Justice,25116,0,25116
"Hickenlooper, John",(D),University of Wisconsin,23982,0,23982
"Hickenlooper, John",(D),University of Michigan,23833,0,23833
"Hickenlooper, John",(D),US Dept of Veterans Affairs,23791,0,23791
"Hickenlooper, John",(D),Creative Artists Agency,23765,0,23765
"Hickenlooper, John",(D),Johns Hopkins University,23519,0,23519
"Hickenlooper, John",(D),Lumen Technologies,23403,1000,22403
"Hickenlooper, John",(D),GCM Grosvenor,23356,0,23356
"Hickenlooper, John",(D),Denver Health & Hospital Authority,23318,0,23318
"Hickenlooper, John",(D),Freedom Road LLC (Colorado),23200,0,23200
"Hickenlooper, John",(D),City University of New York,23189,0,23189
"Hickenlooper, John",(D),US Dept of Defense,23129,0,23129
"Hickenlooper, John",(D),JPMorgan Chase & Co,22888,0,22888
"Hickenlooper, John",(D),Rudin Management,22452,0,22452
"Hickenlooper, John",(D),Grain Management LLC,22400,0,22400
"Hickenlooper, John",(D),High Meadows Foundation,22400,0,22400
"Hickenlooper, John",(D),Amblin Partners,22383,0,22383
"Hickenlooper, John",(D),Northwestern University,22008,0,22008
"Hickenlooper, John",(D),University of Texas,21918,0,21918
"Hickenlooper, John",(D),Intel Corp,21860,0,21860
"Hickenlooper, John",(D),Breckenridge Grand Vacations,21828,0,21828
"Hickenlooper, John",(D),Moelis & Co,21742,0,21742
"Hickenlooper, John",(D),Blackstone Group,21563,0,21563
"Hickenlooper, John",(D),Tufts University,21472,0,21472
"Hickenlooper, John",(D),Laborers Union,21098,20000,1098
"Hickenlooper, John",(D),California State University,20959,0,20959
"Hickenlooper, John",(D),Netflix Inc,20838,0,20838
"Hickenlooper, John",(D),Boston University,20760,0,20760
"Hickenlooper, John",(D),Cranemere LLC,20600,0,20600
"Hirono, Mazie K",(D),Emily's List,52955,10000,42955
"Hirono, Mazie K",(D),Matson Inc,46846,26346,20500
"Hirono, Mazie K",(D),Intellectual Ventures LLC,42000,31500,10500
"Hirono, Mazie K",(D),General Dynamics,40020,40000,20
"Hirono, Mazie K",(D),American Hotel & Lodging Assn,40000,40000,0
"Hirono, Mazie K",(D),"Kobayashi, Sugita & Goda",38850,0,38850
"Hirono, Mazie K",(D),Seafarers International Union,37160,37010,150
"Hirono, Mazie K",(D),NCTA The Internet & Television Assn,35500,30000,5500
"Hirono, Mazie K",(D),Wine & Spirits Wholesalers of America,35000,35000,0
"Hirono, Mazie K",(D),United Parcel Service,34780,34500,280
"Hirono, Mazie K",(D),Huntington Ingalls Industries,34500,34500,0
"Hirono, Mazie K",(D),Comcast Corp,32955,25000,7955
"Hirono, Mazie K",(D),Charter Communications,31000,31000,0
"Hirono, Mazie K",(D),Alexander & Baldwin,30900,12000,18900
"Hirono, Mazie K",(D),International Brotherhood of Electrical Workers,30500,30000,500
"Hirono, Mazie K",(D),Nan Inc,30300,0,30300
"Hirono, Mazie K",(D),Northrop Grumman,30179,30000,179
"Hirono, Mazie K",(D),AT&T Inc,28862,28500,362
"Hirono, Mazie K",(D),Air Line Pilots Assn,28000,28000,0
"Hirono, Mazie K",(D),State of Hawaii,25372,0,25372
"Hirono, Mazie K",(D),Merck & Co,25010,25000,10
"Hirono, Mazie K",(D),Parsons Corp,25007,25000,7
"Hirono, Mazie K",(D),National Assn of Convenience Stores,25000,25000,0
"Hirono, Mazie K",(D),Poet LLC,25000,25000,0
"Hirono, Mazie K",(D),BAE Systems,24751,22000,2751
"Hirono, Mazie K",(D),RM Towill Corp,24600,0,24600
"Hirono, Mazie K",(D),Hawaiian Airlines,23528,17700,5828
"Hirono, Mazie K",(D),University of Hawaii,23114,0,23114
"Hirono, Mazie K",(D),"Deeley, King et al",23100,0,23100
"Hirono, Mazie K",(D),Google Inc,21734,21500,234
"Hirono, Mazie K",(D),Pfizer Inc,21050,21000,50
"Hirono, Mazie K",(D),Lockheed Martin,20030,20000,30
"Hirono, Mazie K",(D),Honeywell International,20011,20000,11
"Hirono, Mazie K",(D),American Society of Anesthesiologists,20000,20000,0
"Hirono, Mazie K",(D),L3Harris Technologies,20000,20000,0
"Hirono, Mazie K",(D),National Assn of Broadcasters,20000,20000,0
"Hirono, Mazie K",(D),AbbVie Inc,19000,19000,0
"Hirono, Mazie K",(D),Alston & Bird,19000,11500,7500
"Hirono, Mazie K",(D),National Assn of Realtors,19000,19000,0
"Hirono, Mazie K",(D),PricewaterhouseCoopers,18525,18500,25
"Hirono, Mazie K",(D),American Society of Travel Advisors,18500,18500,0
"Hirono, Mazie K",(D),"Akin, Gump et al",17875,6000,11875
"Hirono, Mazie K",(D),UNITE HERE,17500,17500,0
"Hirono, Mazie K",(D),Cooney & Conway,17200,0,17200
"Hirono, Mazie K",(D),Hawaiian Electric Industries,17150,0,17150
"Hirono, Mazie K",(D),American Dental Assn,17000,17000,0
"Hirono, Mazie K",(D),Microsoft Corp,16816,16000,816
"Hirono, Mazie K",(D),Covington & Burling,16500,15000,1500
"Hirono, Mazie K",(D),National Assn of Surety Bond Producers,16500,16500,0
"Hirono, Mazie K",(D),RTX Corp,15535,15500,35
"Hirono, Mazie K",(D),National Assn of Letter Carriers,15500,15500,0
"Hirono, Mazie K",(D),"Wilson, Sonsini et al",15400,0,15400
"Hirono, Mazie K",(D),League of Conservation Voters,15374,10999,4375
"Hirono, Mazie K",(D),Pasha Group,15100,0,15100
"Hirono, Mazie K",(D),Service Employees International Union,15030,10000,5030
"Hirono, Mazie K",(D),Operating Engineers Union,15025,15000,25
"Hirono, Mazie K",(D),American Crystal Sugar,15000,15000,0
"Hirono, Mazie K",(D),CAPA21,15000,15000,0
"Hirono, Mazie K",(D),International Assn of Fire Fighters,15000,15000,0
"Hirono, Mazie K",(D),Ironworkers Union,15000,15000,0
"Hirono, Mazie K",(D),National Multifamily Housing Council,15000,15000,0
"Hirono, Mazie K",(D),New York Life Insurance,15000,15000,0
"Hirono, Mazie K",(D),State of California,14039,0,14039
"Hirono, Mazie K",(D),American Federation of State/Cnty/Munic Employees,14000,14000,0
"Hirono, Mazie K",(D),Cox Enterprises,14000,14000,0
"Hirono, Mazie K",(D),DISH Network,14000,14000,0
"Hirono, Mazie K",(D),National Air Traffic Controllers Assn,13500,13500,0
"Hirono, Mazie K",(D),Davis Levin Livingston,13463,0,13463
"Hirono, Mazie K",(D),Paracom Inc,13300,0,13300
"Hirono, Mazie K",(D),Carlsmith Ball LLP,13000,0,13000
"Hirono, Mazie K",(D),Strategies 360,12950,0,12950
"Hirono, Mazie K",(D),Williams & Jensen,12900,1000,11900
"Hirono, Mazie K",(D),Cades Schutte Llp,12600,0,12600
"Hirono, Mazie K",(D),NextEra Energy,12510,11500,1010
"Hirono, Mazie K",(D),Council of Insurance Agents & Brokers,12500,12500,0
"Hirono, Mazie K",(D),Credit Union National Assn,12500,12500,0
"Hirono, Mazie K",(D),Forbes Tate Partners,12500,0,12500
"Hirono, Mazie K",(D),National Beer Wholesalers Assn,12500,12500,0
"Hirono, Mazie K",(D),Clifford Law Offices,12300,0,12300
"Hirono, Mazie K",(D),Power Rogers LLP,12175,0,12175
"Hirono, Mazie K",(D),AECOM Global,12150,1000,11150
"Hirono, Mazie K",(D),Walmart Inc,12118,11000,1118
"Hirono, Mazie K",(D),"Starn, O'Toole et al",11050,0,11050
"Hirono, Mazie K",(D),AFLAC Inc,11000,11000,0
"Hirono, Mazie K",(D),Lauder Partners,11000,0,11000
"Hirono, Mazie K",(D),"Sheet Metal, Air, Rail & Transportation Union",11000,11000,0
"Hirono, Mazie K",(D),Toyota Motor North America,11000,11000,0
"Hirono, Mazie K",(D),American Assn for Justice,10877,10000,877
"Hirono, Mazie K",(D),Corning Inc,10525,10500,25
"Hirono, Mazie K",(D),Center for American Progress,10500,0,10500
"Hirono, Mazie K",(D),Pop Fishing & Marine,10500,0,10500
"Hirono, Mazie K",(D),Deloitte LLP,10253,10000,253
"Hirono, Mazie K",(D),Hilton Worldwide,10020,10000,20
"Hirono, Mazie K",(D),National Education Assn,10020,10000,20
"Hirono, Mazie K",(D),Moveon.org,10006,10000,6
"Hirono, Mazie K",(D),America Works,10000,10000,0
"Hirono, Mazie K",(D),American Council of Engineering Cos,10000,10000,0
"Hirono, Mazie K",(D),American Federation of Teachers,10000,10000,0
"Hirono, Mazie K",(D),American Waterways Operators,10000,10000,0
"Hirono, Mazie K",(D),Anheuser-Busch,10000,10000,0
"Hoeven, John",(R),Hess Corp,58400,10000,48400
"Hoeven, John",(R),Northrop Grumman,47575,47500,75
"Hoeven, John",(R),BNSF Railway,44490,24500,19990
"Hoeven, John",(R),NextEra Energy,41300,27000,14300
"Hoeven, John",(R),Microsoft Corp,41000,41000,0
"Hoeven, John",(R),Westport Properties,36400,0,36400
"Hoeven, John",(R),ClearPath Foundation,35800,0,35800
"Hoeven, John",(R),Automotive Free International Trade PAC,35000,35000,0
"Hoeven, John",(R),Honeywell International,35000,35000,0
"Hoeven, John",(R),RTX Corp,35000,35000,0
"Hoeven, John",(R),Edison Chouest Offshore,34700,0,34700
"Hoeven, John",(R),American Crystal Sugar,32070,29000,3070
"Hoeven, John",(R),Home Depot,31000,31000,0
"Hoeven, John",(R),Lockheed Martin,30005,29000,1005
"Hoeven, John",(R),American Bankers Assn,28500,28500,0
"Hoeven, John",(R),Crop Insurance Professionals Assn,27000,27000,0
"Hoeven, John",(R),Pinnacle West Capital,26500,26500,0
"Hoeven, John",(R),General Atomics,26200,23500,2700
"Hoeven, John",(R),Deloitte LLP,25686,25000,686
"Hoeven, John",(R),Anheuser-Busch,25000,25000,0
"Hoeven, John",(R),California Dairies Inc,25000,25000,0
"Hoeven, John",(R),National Cotton Council,25000,25000,0
"Hoeven, John",(R),Delta Air Lines,24500,24500,0
"Hoeven, John",(R),American Hotel & Lodging Assn,23500,23500,0
"Hoeven, John",(R),Marvin Windows,22533,0,22533
"Hoeven, John",(R),National Assn of Convenience Stores,22500,22500,0
"Hoeven, John",(R),Comcast Corp,22000,22000,0
"Hoeven, John",(R),Shakopee Mdewakanton Sioux Community,21800,0,21800
"Hoeven, John",(R),National Rural Water Assn,21000,21000,0
"Hoeven, John",(R),American Dental Assn,20500,20500,0
"Hoeven, John",(R),Credit Union National Assn,20500,20500,0
"Hoeven, John",(R),International Dairy Foods Assn,20500,14000,6500
"Hoeven, John",(R),Arkansas for Leadership,20000,20000,0
"Hoeven, John",(R),Jennmar Corp,20000,0,20000
"Hoeven, John",(R),Lank PAC,20000,20000,0
"Hoeven, John",(R),Amgen Inc,19500,19500,0
"Hoeven, John",(R),National Electrical Contractors Assn,19000,19000,0
"Hoeven, John",(R),National Assn of Realtors,18500,18500,0
"Hoeven, John",(R),Air Line Pilots Assn,18000,18000,0
"Hoeven, John",(R),Cherokee Nation,17900,0,17900
"Hoeven, John",(R),American Institute of CPAs,17500,17500,0
"Hoeven, John",(R),Wine & Spirits Wholesalers of America,17500,17500,0
"Hoeven, John",(R),Denali Leadership PAC,17305,17305,0
"Hoeven, John",(R),Lockridge Grindal Nauen PLLP,17145,11500,5645
"Hoeven, John",(R),National Rural Electric Cooperative Assn,17000,17000,0
"Hoeven, John",(R),Select Energy Services,16200,0,16200
"Hoeven, John",(R),National Air Traffic Controllers Assn,16000,16000,0
"Hoeven, John",(R),Plains Cotton Growers,16000,15000,1000
"Hoeven, John",(R),Continental Resources,15700,8000,7700
"Hoeven, John",(R),Bill & Melinda Gates Foundation,15500,0,15500
"Hoeven, John",(R),Marathon Petroleum,15500,15500,0
"Hoeven, John",(R),National Assn of Real Estate Investment Trusts,15500,15500,0
"Hoeven, John",(R),NACCO Industries,15450,10000,5450
"Hoeven, John",(R),AT&T Inc,15005,15000,5
"Hoeven, John",(R),American Health Care Assn,15000,15000,0
"Hoeven, John",(R),CoreCivic Inc,15000,15000,0
"Hoeven, John",(R),Free State PAC,15000,15000,0
"Hoeven, John",(R),National Multifamily Housing Council,15000,15000,0
"Hoeven, John",(R),Poarch Band of Creek Indians,15000,0,15000
"Hoeven, John",(R),Verizon Communications,15000,15000,0
"Hoeven, John",(R),Hubbard Broadcasting,14900,0,14900
"Hoeven, John",(R),Mbi Energy Services,14520,0,14520
"Hoeven, John",(R),Farm Credit Council,14500,14500,0
"Hoeven, John",(R),Huntington Ingalls Industries,14500,14500,0
"Hoeven, John",(R),National Auto Dealers Assn,14500,14500,0
"Hoeven, John",(R),American Maritime Officers,14000,14000,0
"Hoeven, John",(R),Ernst & Young,14000,14000,0
"Hoeven, John",(R),FedEx Corp,13500,13500,0
"Hoeven, John",(R),Lignite Energy Council,13500,13500,0
"Hoeven, John",(R),National Shooting Sports Foundation,13500,13500,0
"Hoeven, John",(R),CHS Inc,13400,13400,0
"Hoeven, John",(R),NorPAC,13200,0,13200
"Hoeven, John",(R),Beverage Wholesalers Inc,13040,0,13040
"Hoeven, John",(R),Boeing Co,13025,13000,25
"Hoeven, John",(R),Blue Cross & Blue Shield Assn,13020,13000,20
"Hoeven, John",(R),AFLAC Inc,13000,13000,0
"Hoeven, John",(R),American Trucking Assns,12700,10000,2700
"Hoeven, John",(R),Independent Community Bankers of America,12500,12500,0
"Hoeven, John",(R),Natural Products Assn,12500,12500,0
"Hoeven, John",(R),Thrivent Financial,12500,12500,0
"Hoeven, John",(R),Wild & Wonderful PAC,12500,12500,0
"Hoeven, John",(R),Cardinal Glass,12175,0,12175
"Hoeven, John",(R),Basin Electric Power Cooperative,12100,12100,0
"Hoeven, John",(R),Abbott Laboratories,12000,12000,0
"Hoeven, John",(R),Goldman Sachs,12000,12000,0
"Hoeven, John",(R),Heritage Insurance,12000,0,12000
"Hoeven, John",(R),"National Stone, Sand & Gravel Assn",12000,12000,0
"Hoeven, John",(R),NTCA/Rural Broadband Assn,12000,12000,0
"Hoeven, John",(R),United Parcel Service,12000,12000,0
"Hoeven, John",(R),Apollo Management,11800,0,11800
"Hoeven, John",(R),Chord Energy,11700,4500,7200
"Hoeven, John",(R),Amtrust Financial Services,11550,0,11550
"Hoeven, John",(R),Duke Energy,11500,11500,0
"Hoeven, John",(R),Sempra Energy,11500,11500,0
"Hoeven, John",(R),Poet LLC,11200,8000,3200
"Hoeven, John",(R),AbbVie Inc,11000,11000,0
"Hoeven, John",(R),Ecolab Inc,11000,11000,0
"Hoeven, John",(R),Northwest Respiratory Service,11000,0,11000
"Hoeven, John",(R),Bernard Marcus Family Foundation,10800,0,10800
"Hoeven, John",(R),Boich Companies,10800,0,10800
"Hollen, Chris Van",(D),Votesane PAC,162250,0,162250
"Hollen, Chris Van",(D),US Dept of Health & Human Services,111176,0,111176
"Hollen, Chris Van",(D),ArentFox Schiff,80470,10000,70470
"Hollen, Chris Van",(D),Arnold & Porter,76850,5000,71850
"Hollen, Chris Van",(D),WilmerHale LLP,72764,0,72764
"Hollen, Chris Van",(D),University of Maryland,72005,0,72005
"Hollen, Chris Van",(D),Dentons,69276,2500,66776
"Hollen, Chris Van",(D),Clinical Care Options,65500,0,65500
"Hollen, Chris Van",(D),JStreetPAC,56125,1000,55125
"Hollen, Chris Van",(D),Marriott International,54465,12500,41965
"Hollen, Chris Van",(D),Deloitte LLP,52656,22500,30156
"Hollen, Chris Van",(D),Johns Hopkins University,50530,0,50530
"Hollen, Chris Van",(D),US Dept of Justice,48485,0,48485
"Hollen, Chris Van",(D),Northwestern Mutual,48285,25000,23285
"Hollen, Chris Van",(D),Venable LLP,47478,1000,46478
"Hollen, Chris Van",(D),Emergent Biosolutions,41734,2000,39734
"Hollen, Chris Van",(D),"Skadden, Arps et al",41570,5000,36570
"Hollen, Chris Van",(D),Total Wine & More,41500,0,41500
"Hollen, Chris Van",(D),Montgomery County Public Schools,40733,0,40733
"Hollen, Chris Van",(D),Covington & Burling,40675,0,40675
"Hollen, Chris Van",(D),Berkshire Hathaway,37763,17500,20263
"Hollen, Chris Van",(D),"Akin, Gump et al",35809,0,35809
"Hollen, Chris Van",(D),Morgan Lewis LLP,35625,0,35625
"Hollen, Chris Van",(D),US Government,35425,0,35425
"Hollen, Chris Van",(D),Northrop Grumman,35093,27000,8093
"Hollen, Chris Van",(D),Crowell & Moring,34445,2000,32445
"Hollen, Chris Van",(D),National Assn of Real Estate Investment Trusts,34350,25000,9350
"Hollen, Chris Van",(D),Infinite Computer Solutions,33300,0,33300
"Hollen, Chris Van",(D),Tristar Technology Group,32800,0,32800
"Hollen, Chris Van",(D),State of Maryland,32755,0,32755
"Hollen, Chris Van",(D),National Assn of Realtors,32703,30510,2193
"Hollen, Chris Van",(D),"Montgomery County, MD",31855,0,31855
"Hollen, Chris Van",(D),Cornerstone Government Affairs,31700,0,31700
"Hollen, Chris Van",(D),Choice Hotels International,31410,0,31410
"Hollen, Chris Van",(D),Promontory Interfinancial Network,31250,0,31250
"Hollen, Chris Van",(D),K&L Gates,31175,2000,29175
"Hollen, Chris Van",(D),"Regan, Zambri & Long",30300,0,30300
"Hollen, Chris Van",(D),American Hotel & Lodging Assn,30000,30000,0
"Hollen, Chris Van",(D),"Buchanan, Ingersoll & Rooney",29110,0,29110
"Hollen, Chris Van",(D),DLA Piper,29000,10000,19000
"Hollen, Chris Van",(D),AT&T Inc,28422,19000,9422
"Hollen, Chris Van",(D),Shelter Group,27700,0,27700
"Hollen, Chris Van",(D),IBM Corp,26932,0,26932
"Hollen, Chris Van",(D),Conceptual Analytics LLC,26800,0,26800
"Hollen, Chris Van",(D),Paley Rothman,26750,0,26750
"Hollen, Chris Van",(D),National Multifamily Housing Council,26550,25000,1550
"Hollen, Chris Van",(D),Holland & Knight,26150,2500,23650
"Hollen, Chris Van",(D),NASDAQ Inc,26000,7000,19000
"Hollen, Chris Van",(D),Bill & Melinda Gates Foundation,25650,0,25650
"Hollen, Chris Van",(D),"Paul, Weiss Et Al",25650,0,25650
"Hollen, Chris Van",(D),American University,25426,0,25426
"Hollen, Chris Van",(D),Institute for Health Technology Studie,25300,0,25300
"Hollen, Chris Van",(D),Georgetown University,25080,0,25080
"Hollen, Chris Van",(D),National Beer Wholesalers Assn,25000,25000,0
"Hollen, Chris Van",(D),George Washington University,24800,0,24800
"Hollen, Chris Van",(D),Hogan Lovells,24650,0,24650
"Hollen, Chris Van",(D),Nai Michael Co,24600,0,24600
"Hollen, Chris Van",(D),"McDermott, Will & Emery",24507,2500,22007
"Hollen, Chris Van",(D),"Ober, Kaler et al",23900,0,23900
"Hollen, Chris Van",(D),League of Conservation Voters,23679,7227,16452
"Hollen, Chris Van",(D),Medstar Health,23570,0,23570
"Hollen, Chris Van",(D),Honeywell International,23500,22500,1000
"Hollen, Chris Van",(D),Mortgage Bankers Assn,23250,22500,750
"Hollen, Chris Van",(D),America's Credit Unions,22750,22000,750
"Hollen, Chris Van",(D),National Active & Retired Federal Employees Assn,22750,22500,250
"Hollen, Chris Van",(D),Comcast Corp,22550,7500,15050
"Hollen, Chris Van",(D),Laborers Union,22500,22500,0
"Hollen, Chris Van",(D),Phillips & Cohen,22350,0,22350
"Hollen, Chris Van",(D),USAA,22255,17500,4755
"Hollen, Chris Van",(D),Morrison & Foerster,22200,0,22200
"Hollen, Chris Van",(D),"Gallagher, Evelius & Jones",22150,0,22150
"Hollen, Chris Van",(D),Fairfield County Community Foundation,21600,0,21600
"Hollen, Chris Van",(D),Lone Pine Capital,21600,0,21600
"Hollen, Chris Van",(D),Peter G Peterson Foundation,21600,0,21600
"Hollen, Chris Van",(D),Centerbridge Partners,21400,0,21400
"Hollen, Chris Van",(D),Blue Cross/Blue Shield,21100,8000,13100
"Hollen, Chris Van",(D),NFP Corp,21050,0,21050
"Hollen, Chris Van",(D),Steptoe & Johnson,21000,0,21000
"Hollen, Chris Van",(D),National Air Traffic Controllers Assn,20500,20500,0
"Hollen, Chris Van",(D),National Education Assn,20500,15000,5500
"Hollen, Chris Van",(D),Hendersen-Webb Inc,20300,0,20300
"Hollen, Chris Van",(D),Cherokee Nation,20200,0,20200
"Hollen, Chris Van",(D),Air Line Pilots Assn,20000,20000,0
"Hollen, Chris Van",(D),International Assn of Fire Fighters,20000,20000,0
"Hollen, Chris Van",(D),Massachusetts Mutual Life Insurance,20000,18000,2000
"Hollen, Chris Van",(D),National Assn of Letter Carriers,20000,20000,0
"Hollen, Chris Van",(D),Real Estate Roundtable,20000,20000,0
"Hollen, Chris Van",(D),Politics & Prose Bookstore,19900,0,19900
"Hollen, Chris Van",(D),Nextnav LLC,19350,0,19350
"Hollen, Chris Van",(D),Riverside Health,19150,0,19150
"Hollen, Chris Van",(D),WPP plc,18913,0,18913
"Hollen, Chris Van",(D),Hines Interests,18900,0,18900
"Hollen, Chris Van",(D),Peterson Companies,18900,0,18900
"Hollen, Chris Van",(D),Smithsonian American Art Museum,18800,0,18800
"Hollen, Chris Van",(D),Mental Wellness Assoc,18700,0,18700
"Hollen, Chris Van",(D),Beowulf Energy,18600,0,18600
"Hollen, Chris Van",(D),FI Investment Group,18500,0,18500
"Hollen, Chris Van",(D),New York Life Insurance,18500,17500,1000
"Hollen, Chris Van",(D),Lockheed Martin,18380,15000,3380
"Hollen, Chris Van",(D),Ciena Healthcare Management,18200,0,18200
"Hyde-Smith, Cindy",(R),Seemann Composites,36300,0,36300
"Hyde-Smith, Cindy",(R),Telapex Inc,34180,10000,24180
"Hyde-Smith, Cindy",(R),Ergon Inc,29400,0,29400
"Hyde-Smith, Cindy",(R),Huntington Ingalls Industries,28778,15000,13778
"Hyde-Smith, Cindy",(R),Sanderson Farms,26400,0,26400
"Hyde-Smith, Cindy",(R),National Assn of Realtors,25000,25000,0
"Hyde-Smith, Cindy",(R),NorPAC,24320,0,24320
"Hyde-Smith, Cindy",(R),General Atomics,23175,17500,5675
"Hyde-Smith, Cindy",(R),Addicus,22100,0,22100
"Hyde-Smith, Cindy",(R),Community Bancshares of Mississippi,20500,10000,10500
"Hyde-Smith, Cindy",(R),American Bankers Assn,20025,20000,25
"Hyde-Smith, Cindy",(R),Golding Barge Line,19400,0,19400
"Hyde-Smith, Cindy",(R),Leidos Inc,19000,10000,9000
"Hyde-Smith, Cindy",(R),Comcast Corp,17562,17500,62
"Hyde-Smith, Cindy",(R),American Dental Assn,17500,17500,0
"Hyde-Smith, Cindy",(R),Pruet Oil,16800,0,16800
"Hyde-Smith, Cindy",(R),Yates Construction,16800,0,16800
"Hyde-Smith, Cindy",(R),Corporate Capital LLC,15800,0,15800
"Hyde-Smith, Cindy",(R),Waypoint Consulting,15300,0,15300
"Hyde-Smith, Cindy",(R),Raytheon Technologies,15135,15000,135
"Hyde-Smith, Cindy",(R),Southern Co,15005,15000,5
"Hyde-Smith, Cindy",(R),Capitol Resources,13500,0,13500
"Hyde-Smith, Cindy",(R),Freeport-McMoRan,13100,5000,8100
"Hyde-Smith, Cindy",(R),Mortgage Bankers Assn,12500,12500,0
"Hyde-Smith, Cindy",(R),National Multifamily Housing Council,12500,12500,0
"Hyde-Smith, Cindy",(R),Butler Snow LLP,12000,10000,2000
"Hyde-Smith, Cindy",(R),Wade Inc,11600,0,11600
"Hyde-Smith, Cindy",(R),"Akin, Gump et al",11500,2500,9000
"Hyde-Smith, Cindy",(R),Alticor Inc,11200,0,11200
"Hyde-Smith, Cindy",(R),Clearpath Foundation,11200,0,11200
"Hyde-Smith, Cindy",(R),G&S Holdings,11200,0,11200
"Hyde-Smith, Cindy",(R),Malvaney & Assoc,11200,0,11200
"Hyde-Smith, Cindy",(R),Mountaire Corp,11200,0,11200
"Hyde-Smith, Cindy",(R),National Aviation Academy,11200,0,11200
"Hyde-Smith, Cindy",(R),RDV Corp,11200,0,11200
"Hyde-Smith, Cindy",(R),Sexton Companies,11200,0,11200
"Hyde-Smith, Cindy",(R),Station Casinos,11200,0,11200
"Hyde-Smith, Cindy",(R),Ultimate Fighting Championship,11200,0,11200
"Hyde-Smith, Cindy",(R),Witkoff Group,11200,0,11200
"Hyde-Smith, Cindy",(R),USA Rice Federation,11000,11000,0
"Hyde-Smith, Cindy",(R),Toyota Motor North America,10999,10142,857
"Hyde-Smith, Cindy",(R),VT Halter Marine,10850,5000,5850
"Hyde-Smith, Cindy",(R),Exxon Mobil,10648,10000,648
"Hyde-Smith, Cindy",(R),Dunlap & Kyle,10600,0,10600
"Hyde-Smith, Cindy",(R),NACCO Industries,10300,5000,5300
"Hyde-Smith, Cindy",(R),Boeing Co,10150,10000,150
"Hyde-Smith, Cindy",(R),LOCKHEED MARTIN,10090,10000,90
"Hyde-Smith, Cindy",(R),Caterpillar Inc,10018,10000,18
"Hyde-Smith, Cindy",(R),Chevron Corp,10005,10000,5
"Hyde-Smith, Cindy",(R),Alamo PAC,10000,10000,0
"Hyde-Smith, Cindy",(R),Altria Group,10000,10000,0
"Hyde-Smith, Cindy",(R),American Academy of Pediatric Dentistry,10000,10000,0
"Hyde-Smith, Cindy",(R),American Crystal Sugar,10000,10000,0
"Hyde-Smith, Cindy",(R),American Optometric Assn,10000,10000,0
"Hyde-Smith, Cindy",(R),American Waterways Operators,10000,10000,0
"Hyde-Smith, Cindy",(R),Associated Builders & Contractors,10000,10000,0
"Hyde-Smith, Cindy",(R),Automotive Free International Trade PAC,10000,10000,0
"Hyde-Smith, Cindy",(R),Bluegrass Cmte,10000,10000,0
"Hyde-Smith, Cindy",(R),Citizens Organized PAC,10000,10000,0
"Hyde-Smith, Cindy",(R),Denali Leadership PAC,10000,10000,0
"Hyde-Smith, Cindy",(R),Dirigo PAC,10000,10000,0
"Hyde-Smith, Cindy",(R),Farm Credit Council,10000,10000,0
"Hyde-Smith, Cindy",(R),Free State PAC,10000,10000,0
"Hyde-Smith, Cindy",(R),Freedom Fund,10000,10000,0
"Hyde-Smith, Cindy",(R),Fund for America's Future,10000,10000,0
"Hyde-Smith, Cindy",(R),Halliburton Co,10000,10000,0
"Hyde-Smith, Cindy",(R),Heartland Values PAC,10000,10000,0
"Hyde-Smith, Cindy",(R),"Jobs, Opportunity & New Ideas PAC",10000,10000,0
"Hyde-Smith, Cindy",(R),MARSHA PAC,10000,10000,0
"Hyde-Smith, Cindy",(R),McRight Services,10000,0,10000
"Hyde-Smith, Cindy",(R),Mississippi ACRE,10000,10000,0
"Hyde-Smith, Cindy",(R),National Assn of Home Builders,10000,10000,0
"Hyde-Smith, Cindy",(R),National Assn of Wholesaler-Distributors,10000,10000,0
"Hyde-Smith, Cindy",(R),National Auto Dealers Assn,10000,10000,0
"Hyde-Smith, Cindy",(R),National Beer Wholesalers Assn,10000,10000,0
"Hyde-Smith, Cindy",(R),National Chicken Council,10000,10000,0
"Hyde-Smith, Cindy",(R),National Cotton Council,10000,10000,0
"Hyde-Smith, Cindy",(R),Nebraska Sandhills PAC,10000,10000,0
"Hyde-Smith, Cindy",(R),Next Century Fund,10000,10000,0
"Hyde-Smith, Cindy",(R),One Georgia PAC,10000,10000,0
"Hyde-Smith, Cindy",(R),Oorah! PAC,10000,10000,0
"Hyde-Smith, Cindy",(R),Pelican PAC,10000,10000,0
"Hyde-Smith, Cindy",(R),Rely on Your Beliefs,10000,10000,0
"Hyde-Smith, Cindy",(R),Responsibility & Freedom Work PAC,10000,10000,0
"Hyde-Smith, Cindy",(R),Tenn PAC,10000,10000,0
"Hyde-Smith, Cindy",(R),US Chamber of Commerce,10000,10000,0
"Hyde-Smith, Cindy",(R),Value in Electing Women PAC,10000,10000,0
"Hyde-Smith, Cindy",(R),Cornerstone Government Affairs,9749,0,9749
"Hyde-Smith, Cindy",(R),Entergy Corp,8650,8500,150
"Hyde-Smith, Cindy",(R),"Maynard, Cooper & Gale",8500,8500,0
"Hyde-Smith, Cindy",(R),Maritime Development Center,8400,0,8400
"Hyde-Smith, Cindy",(R),North American Midway Entertainment,8400,0,8400
"Hyde-Smith, Cindy",(R),Trammell Crow Residential,8400,0,8400
"Hyde-Smith, Cindy",(R),Astn Group,8050,0,8050
"Hyde-Smith, Cindy",(R),Southern Pipe & Supply,8000,0,8000
"Hyde-Smith, Cindy",(R),Mississippi Farm Bureau Federation,7800,7800,0
"Hyde-Smith, Cindy",(R),Aerojet Rocketdyne,7600,7500,100
"Hyde-Smith, Cindy",(R),Idaho Forest Group,7600,0,7600
"Hyde-Smith, Cindy",(R),Regions Financial,7600,7500,100
"Hyde-Smith, Cindy",(R),Arkansas for Leadership,7500,7500,0
"Johnson, Ron",(R),Club for Growth,525033,0,525033
"Johnson, Ron",(R),Northwestern Mutual,105490,17500,87990
"Johnson, Ron",(R),Foley & Lardner,57325,2000,55325
"Johnson, Ron",(R),NorPAC,54300,0,54300
"Johnson, Ron",(R),Abc Supply,48806,0,48806
"Johnson, Ron",(R),Advocate Health,48797,0,48797
"Johnson, Ron",(R),Honeywell International,46980,36000,10980
"Johnson, Ron",(R),National Republican Senatorial Cmte,46800,46800,0
"Johnson, Ron",(R),AT&T Inc,45520,44500,1020
"Johnson, Ron",(R),Jennmar Corp,42900,0,42900
"Johnson, Ron",(R),Elliott Management,40400,0,40400
"Johnson, Ron",(R),CSX Corp,40000,40000,0
"Johnson, Ron",(R),Union Pacific Corp,40000,40000,0
"Johnson, Ron",(R),American Institute of CPAs,39000,39000,0
"Johnson, Ron",(R),Speed Systems Inc,38500,0,38500
"Johnson, Ron",(R),Station Casinos,37400,0,37400
"Johnson, Ron",(R),AegisPAC,36500,0,36500
"Johnson, Ron",(R),Robert W Baird & Co,36400,0,36400
"Johnson, Ron",(R),NCTA The Internet & Television Assn,36000,36000,0
"Johnson, Ron",(R),American Bankers Assn,35250,35000,250
"Johnson, Ron",(R),United Parcel Service,34925,29500,5425
"Johnson, Ron",(R),Sargento Foods,33650,0,33650
"Johnson, Ron",(R),Deloitte LLP,32600,32500,100
"Johnson, Ron",(R),Koch Industries,32500,19000,13500
"Johnson, Ron",(R),National Assn of Convenience Stores,32500,32500,0
"Johnson, Ron",(R),Wells Fargo,32435,7500,24935
"Johnson, Ron",(R),Comcast Corp,32000,31500,500
"Johnson, Ron",(R),Berkshire Hathaway,31870,29000,2870
"Johnson, Ron",(R),Belmark Inc,30700,0,30700
"Johnson, Ron",(R),Northrop Grumman,30550,30000,550
"Johnson, Ron",(R),Stephens Inc,30400,5000,25400
"Johnson, Ron",(R),Johnson Controls International,30000,14500,15500
"Johnson, Ron",(R),Norfolk Southern,30000,30000,0
"Johnson, Ron",(R),UnitedHealth Group,29800,13500,16300
"Johnson, Ron",(R),Oshkosh Corp,29039,5000,24039
"Johnson, Ron",(R),Charter Communications,28500,28500,0
"Johnson, Ron",(R),Massachusetts Mutual Life Insurance,28205,20000,8205
"Johnson, Ron",(R),BayCare Clinic,28050,0,28050
"Johnson, Ron",(R),Alta Resources,27950,0,27950
"Johnson, Ron",(R),Altria Group,27900,22500,5400
"Johnson, Ron",(R),Godfrey & Kahn,27610,0,27610
"Johnson, Ron",(R),Direct Supply Inc,27406,5000,22406
"Johnson, Ron",(R),Bank Of America,27335,0,27335
"Johnson, Ron",(R),Rayes Inc,27000,0,27000
"Johnson, Ron",(R),RPM International,26600,5000,21600
"Johnson, Ron",(R),Michels Corp,26300,2700,23600
"Johnson, Ron",(R),RW Selby & Co,26200,0,26200
"Johnson, Ron",(R),FedEx Corp,26148,16000,10148
"Johnson, Ron",(R),Duty Free Americas,25800,0,25800
"Johnson, Ron",(R),Alimentation Couche-Tard,25600,0,25600
"Johnson, Ron",(R),Jack Link's Beef Jerky,25000,0,25000
"Johnson, Ron",(R),Strategy PAC,25000,25000,0
"Johnson, Ron",(R),Wine & Spirits Wholesalers of America,25000,25000,0
"Johnson, Ron",(R),SC Johnson & Son,24885,7700,17185
"Johnson, Ron",(R),Fierce Government Relations,24800,0,24800
"Johnson, Ron",(R),Federal Aviation Admin Managers Assn,24500,24500,0
"Johnson, Ron",(R),Agman Partners,24300,0,24300
"Johnson, Ron",(R),Duchossois Group,24300,0,24300
"Johnson, Ron",(R),"Welsh, Carson et al",24300,0,24300
"Johnson, Ron",(R),Molson Coors Brewing,23820,12000,11820
"Johnson, Ron",(R),Einhorn Assoc,23800,0,23800
"Johnson, Ron",(R),General Electric,23435,17000,6435
"Johnson, Ron",(R),Tamarack Petroleum,23400,0,23400
"Johnson, Ron",(R),AQR Capital Management,23350,0,23350
"Johnson, Ron",(R),Goldman Sachs,23000,6000,17000
"Johnson, Ron",(R),Blackstone Group,22900,0,22900
"Johnson, Ron",(R),UBS AG,22900,15000,7900
"Johnson, Ron",(R),Continental Properties,22850,0,22850
"Johnson, Ron",(R),Ernst & Young,22500,20000,2500
"Johnson, Ron",(R),National Beer Wholesalers Assn,22500,22500,0
"Johnson, Ron",(R),Minnesota Wild,22399,0,22399
"Johnson, Ron",(R),New Berlin Plastics,22250,0,22250
"Johnson, Ron",(R),National Roofing Contractors Assn,22000,22000,0
"Johnson, Ron",(R),Hupy & Abraham,21800,0,21800
"Johnson, Ron",(R),Amway/Alticor Inc,21600,0,21600
"Johnson, Ron",(R),Cmb Regional Centers,21600,0,21600
"Johnson, Ron",(R),Entrepreneurial Corporate Group,21600,0,21600
"Johnson, Ron",(R),Essential Industries,21600,0,21600
"Johnson, Ron",(R),Metalcraft of Mayville,21600,0,21600
"Johnson, Ron",(R),TAMKO Building Products,21600,0,21600
"Johnson, Ron",(R),Templar Securities,21400,0,21400
"Johnson, Ron",(R),Wausau Homes,21400,0,21400
"Johnson, Ron",(R),Woodbranch Investments,21200,0,21200
"Johnson, Ron",(R),Verizon Communications,21003,20000,1003
"Johnson, Ron",(R),Capital Group Companies,20900,0,20900
"Johnson, Ron",(R),Hartung Brothers Inc,20800,0,20800
"Johnson, Ron",(R),Magnolia Marketing,20800,0,20800
"Johnson, Ron",(R),Milksource,20800,0,20800
"Johnson, Ron",(R),WEC Energy Group,20464,5500,14964
"Johnson, Ron",(R),BGR Group,20349,2349,18000
"Johnson, Ron",(R),Lazard Ltd,20300,0,20300
"Johnson, Ron",(R),Kwik Trip Co,20035,0,20035
"Johnson, Ron",(R),Johnsonville Sausage,20004,0,20004
"Johnson, Ron",(R),Freedom Fund,20000,20000,0
"Johnson, Ron",(R),Se,19825,0,19825
"Johnson, Ron",(R),Herzing University,19700,0,19700
"Johnson, Ron",(R),Rowe & Co,19700,0,19700
"Johnson, Ron",(R),Kitzinger Lautmann Capital Management,19400,0,19400
"Johnson, Ron",(R),Nixon Peabody LLP,19400,0,19400
"Johnson, Ron",(R),Radio Systems Corp,19200,0,19200
"Kaine, Tim",(D),JStreetPAC,178967,8910,170057
"Kaine, Tim",(D),Covington & Burling,149200,0,149200
"Kaine, Tim",(D),Altria Group,113576,37500,76076
"Kaine, Tim",(D),Huntington Ingalls Industries,102055,38000,64055
"Kaine, Tim",(D),Holland & Knight,98799,13000,85799
"Kaine, Tim",(D),Latham & Watkins,91875,0,91875
"Kaine, Tim",(D),Northrop Grumman,85988,41500,44488
"Kaine, Tim",(D),Capital Group Companies,85822,30000,55822
"Kaine, Tim",(D),Norfolk Southern,84653,35000,49653
"Kaine, Tim",(D),Dominion Energy,82633,31000,51633
"Kaine, Tim",(D),"Akin, Gump et al",81052,4500,76552
"Kaine, Tim",(D),Golden Gate Capital,78600,0,78600
"Kaine, Tim",(D),Route One Investment,77000,0,77000
"Kaine, Tim",(D),Sullivan & Cromwell,76517,0,76517
"Kaine, Tim",(D),Deloitte LLP,74065,40000,34065
"Kaine, Tim",(D),Bloomberg LP,72975,0,72975
"Kaine, Tim",(D),Microsoft Corp,72652,21500,51152
"Kaine, Tim",(D),League of Conservation Voters,71638,11533,60105
"Kaine, Tim",(D),Goldman Sachs,68250,20000,48250
"Kaine, Tim",(D),Sidley Austin LLP,67775,6000,61775
"Kaine, Tim",(D),King & Spalding,65825,5000,60825
"Kaine, Tim",(D),Centene Corp,63700,15000,48700
"Kaine, Tim",(D),Pinnacle West Capital,62600,39000,23600
"Kaine, Tim",(D),JPMorgan Chase & Co,61400,32000,29400
"Kaine, Tim",(D),Bluestem Asset Management,61200,0,61200
"Kaine, Tim",(D),Cyberdata Technologies,60300,0,60300
"Kaine, Tim",(D),McGuireWoods LLP,60170,7500,52670
"Kaine, Tim",(D),Comcast Corp,58543,35000,23543
"Kaine, Tim",(D),Greenberg Traurig LLP,57825,2500,55325
"Kaine, Tim",(D),Hogan Lovells,57618,4000,53618
"Kaine, Tim",(D),University of Virginia,56971,0,56971
"Kaine, Tim",(D),Wiley Rein LLP,56650,0,56650
"Kaine, Tim",(D),Genworth Financial,55376,11500,43876
"Kaine, Tim",(D),Verizon Communications,54935,10000,44935
"Kaine, Tim",(D),Cerberus Capital Management,53550,28250,25300
"Kaine, Tim",(D),New Richmond Ventures,53200,0,53200
"Kaine, Tim",(D),Hunton Andrews Kurth LLP,52725,0,52725
"Kaine, Tim",(D),Lockheed Martin,51552,41000,10552
"Kaine, Tim",(D),Puma Springs Vineyards,49475,0,49475
"Kaine, Tim",(D),Boeing Co,48890,17500,31390
"Kaine, Tim",(D),Berkshire Hathaway,48579,35000,13579
"Kaine, Tim",(D),Weiss Asset Management,48500,0,48500
"Kaine, Tim",(D),Warburg Pincus,48200,0,48200
"Kaine, Tim",(D),Creative Artists Agency,46700,0,46700
"Kaine, Tim",(D),Jones Day,45830,0,45830
"Kaine, Tim",(D),Reed Smith LLP,45525,7000,38525
"Kaine, Tim",(D),Democracy Engine,45115,0,45115
"Kaine, Tim",(D),Generation Investment Management,45100,0,45100
"Kaine, Tim",(D),Commonwealth of Virginia,45034,0,45034
"Kaine, Tim",(D),AT&T Inc,45007,13000,32007
"Kaine, Tim",(D),Physicians Mutual Insurance,45000,45000,0
"Kaine, Tim",(D),Apex Covantage,44715,0,44715
"Kaine, Tim",(D),Honeywell International,43495,37500,5995
"Kaine, Tim",(D),DLA Piper,43420,10000,33420
"Kaine, Tim",(D),Grant & Eisenhofer,43300,0,43300
"Kaine, Tim",(D),Mortgage Bankers Assn,43100,35000,8100
"Kaine, Tim",(D),SAIC,42800,39500,3300
"Kaine, Tim",(D),Morgan Stanley,42553,9000,33553
"Kaine, Tim",(D),"Kellogg, Hansen et al",40900,0,40900
"Kaine, Tim",(D),Arnold & Porter Kaye Scholer,40887,5000,35887
"Kaine, Tim",(D),"Paul, Weiss et al",40662,0,40662
"Kaine, Tim",(D),Columbus Rose Ltd,40650,0,40650
"Kaine, Tim",(D),Accenture,40404,14000,26404
"Kaine, Tim",(D),United Airlines Holdings,40229,11000,29229
"Kaine, Tim",(D),"Buchanan, Ingersoll & Rooney",39950,0,39950
"Kaine, Tim",(D),Leidos Inc,39923,18500,21423
"Kaine, Tim",(D),General Dynamics,38973,35000,3973
"Kaine, Tim",(D),UBS AG,38700,27500,11200
"Kaine, Tim",(D),University of California,38663,0,38663
"Kaine, Tim",(D),Cimpress plc,38150,0,38150
"Kaine, Tim",(D),Wize Solutions,38100,0,38100
"Kaine, Tim",(D),McCandlish Holton Pc,37900,0,37900
"Kaine, Tim",(D),Micron Technology,37800,30800,7000
"Kaine, Tim",(D),National Air Traffic Controllers Assn,37500,37500,0
"Kaine, Tim",(D),Motley Rice LLC,37400,0,37400
"Kaine, Tim",(D),BAE Systems,36315,34500,1815
"Kaine, Tim",(D),Royal Business Bank,35500,0,35500
"Kaine, Tim",(D),Multi Service Corp,35400,0,35400
"Kaine, Tim",(D),Pfizer Inc,35020,35000,20
"Kaine, Tim",(D),Strategic Analysis Inc,35000,0,35000
"Kaine, Tim",(D),Bank of New York Mellon,34800,6000,28800
"Kaine, Tim",(D),George Washington University,34458,0,34458
"Kaine, Tim",(D),Amazon.com,33945,17500,16445
"Kaine, Tim",(D),American Healthcare LLC,33839,0,33839
"Kaine, Tim",(D),Wilmerhale Llp,33654,0,33654
"Kaine, Tim",(D),Mvm Inc,33400,0,33400
"Kaine, Tim",(D),Edgar Lomax Co,32700,0,32700
"Kaine, Tim",(D),Virginia Commonwealth University,32676,0,32676
"Kaine, Tim",(D),US Government,32577,0,32577
"Kaine, Tim",(D),Alphabet Inc,32510,16000,16510
"Kaine, Tim",(D),"Simpson, Thacher & Bartlett",32300,0,32300
"Kaine, Tim",(D),RTX Corp,32045,29000,3045
"Kaine, Tim",(D),Anheuser-Busch,31525,30000,1525
"Kaine, Tim",(D),National Multifamily Housing Council,31500,31500,0
"Kaine, Tim",(D),American Hospital Assn,31350,30000,1350
"Kaine, Tim",(D),Alston & Bird,31150,20000,11150
"Kaine, Tim",(D),Stanford University,31066,0,31066
"Kaine, Tim",(D),Heising-Simons Foundation,31000,0,31000
"Kaine, Tim",(D),O'Melveny & Myers,30851,0,30851
"Kaine, Tim",(D),Kirkland & Ellis,30733,0,30733
"Kelly, Mark",(D),Democracy Engine,404122,0,404122
"Kelly, Mark",(D),University of California,189832,0,189832
"Kelly, Mark",(D),Alphabet Inc,133466,5000,128466
"Kelly, Mark",(D),University of Arizona,126035,0,126035
"Kelly, Mark",(D),JStreetPAC,120601,0,120601
"Kelly, Mark",(D),Arizona State University,105373,0,105373
"Kelly, Mark",(D),Microsoft Corp,83903,0,83903
"Kelly, Mark",(D),Apple Inc,70618,0,70618
"Kelly, Mark",(D),Amazon.com,62019,0,62019
"Kelly, Mark",(D),US Government,61014,0,61014
"Kelly, Mark",(D),Walt Disney Co,58942,0,58942
"Kelly, Mark",(D),Stanford University,58319,0,58319
"Kelly, Mark",(D),Kirkland & Ellis,56500,0,56500
"Kelly, Mark",(D),Harvard University,53558,0,53558
"Kelly, Mark",(D),Democratic Senatorial Campaign Cmte,51450,51200,250
"Kelly, Mark",(D),Banner Health,49418,0,49418
"Kelly, Mark",(D),Jane Street Group,48500,0,48500
"Kelly, Mark",(D),IBM Corp,47750,0,47750
"Kelly, Mark",(D),Comcast Corp,46895,0,46895
"Kelly, Mark",(D),Intel Corp,46058,0,46058
"Kelly, Mark",(D),Wilmerhale Llp,44201,0,44201
"Kelly, Mark",(D),Raytheon Technologies,42294,0,42294
"Kelly, Mark",(D),"Pima County, AZ",42109,0,42109
"Kelly, Mark",(D),Motley Rice LLC,42000,0,42000
"Kelly, Mark",(D),Warner Brothers Discovery,40184,0,40184
"Kelly, Mark",(D),US Dept of Health & Human Services,39050,0,39050
"Kelly, Mark",(D),Blue Cross/Blue Shield,38658,0,38658
"Kelly, Mark",(D),University of Texas,36819,0,36819
"Kelly, Mark",(D),Wells Fargo,36168,0,36168
"Kelly, Mark",(D),Deer Management,36100,0,36100
"Kelly, Mark",(D),Massachusetts Institute of Technology,35451,0,35451
"Kelly, Mark",(D),State of California,35282,0,35282
"Kelly, Mark",(D),Yale University,34390,0,34390
"Kelly, Mark",(D),Kaiser Permanente,33733,0,33733
"Kelly, Mark",(D),US Dept of Veterans Affairs,33649,0,33649
"Kelly, Mark",(D),US House of Representatives,33535,0,33535
"Kelly, Mark",(D),University of Maryland,32269,0,32269
"Kelly, Mark",(D),University of Washington,31797,0,31797
"Kelly, Mark",(D),Mass General Brigham,31563,0,31563
"Kelly, Mark",(D),Mayo Clinic,31348,0,31348
"Kelly, Mark",(D),US Dept of Defense,30970,0,30970
"Kelly, Mark",(D),California State University,29834,0,29834
"Kelly, Mark",(D),"Akin, Gump et al",29687,5000,24687
"Kelly, Mark",(D),Columbia University,29448,0,29448
"Kelly, Mark",(D),Blackstone Group,29197,0,29197
"Kelly, Mark",(D),"Williams, Hart et al",29000,0,29000
"Kelly, Mark",(D),SV Angel LLC,28200,0,28200
"Kelly, Mark",(D),University of Michigan,28174,0,28174
"Kelly, Mark",(D),NASA,26978,0,26978
"Kelly, Mark",(D),Rudin Management,26600,0,26600
"Kelly, Mark",(D),Snell & Wilmer,26175,0,26175
"Kelly, Mark",(D),JPMorgan Chase & Co,26014,0,26014
"Kelly, Mark",(D),Power Rogers LLP,25675,0,25675
"Kelly, Mark",(D),Ballard Spahr LLP,25665,10000,15665
"Kelly, Mark",(D),"Paul, Weiss et al",25525,0,25525
"Kelly, Mark",(D),University of Chicago,25079,0,25079
"Kelly, Mark",(D),US Dept of the Interior,24701,0,24701
"Kelly, Mark",(D),Boeing Co,24344,0,24344
"Kelly, Mark",(D),Netflix Inc,23923,0,23923
"Kelly, Mark",(D),US Dept of Agriculture,23748,0,23748
"Kelly, Mark",(D),Northrop Grumman,23730,0,23730
"Kelly, Mark",(D),4-D Properties,23400,0,23400
"Kelly, Mark",(D),"Kleiner, Perkins et al",23200,0,23200
"Kelly, Mark",(D),Vistria Group,23200,0,23200
"Kelly, Mark",(D),University of Minnesota,22537,0,22537
"Kelly, Mark",(D),K&L Gates,22275,3000,19275
"Kelly, Mark",(D),Honeywell International,22082,0,22082
"Kelly, Mark",(D),Meta,22056,0,22056
"Kelly, Mark",(D),Cornell University,21668,0,21668
"Kelly, Mark",(D),Raikes Foundation,21600,0,21600
"Kelly, Mark",(D),Deloitte LLP,21375,0,21375
"Kelly, Mark",(D),Bain Capital,21200,0,21200
"Kelly, Mark",(D),"Baker, Donelson et al",21070,0,21070
"Kelly, Mark",(D),"City of New York, NY",20800,0,20800
"Kelly, Mark",(D),Emory University,20517,0,20517
"Kelly, Mark",(D),Johns Hopkins University,20436,0,20436
"Kelly, Mark",(D),University of Colorado,20148,0,20148
"Kelly, Mark",(D),"City & County of San Francisco, CA",20105,0,20105
"Kelly, Mark",(D),Sony Corp,20100,0,20100
"Kelly, Mark",(D),New York University,20080,0,20080
"Kelly, Mark",(D),National Assn of Realtors,20000,20000,0
"Kelly, Mark",(D),American Airlines Group,19973,0,19973
"Kelly, Mark",(D),Susman Godfrey LLP,19900,0,19900
"Kelly, Mark",(D),Sidley Austin LLP,19778,0,19778
"Kelly, Mark",(D),University of Southern California,19524,0,19524
"Kelly, Mark",(D),Silver Lake Partners,19250,0,19250
"Kelly, Mark",(D),United Airlines Holdings,18994,0,18994
"Kelly, Mark",(D),Oaktree Capital Management,18980,0,18980
"Kelly, Mark",(D),University of Wisconsin,18755,0,18755
"Kelly, Mark",(D),Dar Group Investments,18600,0,18600
"Kelly, Mark",(D),Valve Corp,18551,0,18551
"Kelly, Mark",(D),National Education Assn,18379,10000,8379
"Kelly, Mark",(D),Northwestern University,18359,0,18359
"Kelly, Mark",(D),Oracle Corp,18212,0,18212
"Kelly, Mark",(D),Apollo Global Management,18087,0,18087
"Kelly, Mark",(D),Arizona Community Physicians,17990,0,17990
"Kelly, Mark",(D),City University of New York,17987,0,17987
"Kelly, Mark",(D),Arnold & Porter Kaye Scholer,17942,2500,15442
"Kelly, Mark",(D),"Cleary, Gottlieb et al",17708,0,17708
"Kelly, Mark",(D),Abelson Taylor,17600,0,17600
"Kennedy, John",(R),Acadian Ambulance Service,53600,15000,38600
"Kennedy, John",(R),Atco Investment,53500,0,53500
"Kennedy, John",(R),Morris & Dickson,48600,0,48600
"Kennedy, John",(R),Amway/Alticor Inc,48200,5000,43200
"Kennedy, John",(R),Ochsner Health System,42430,0,42430
"Kennedy, John",(R),Central Management,40800,0,40800
"Kennedy, John",(R),Terral River Service,39100,0,39100
"Kennedy, John",(R),"Johnson, Rice & Co",38300,0,38300
"Kennedy, John",(R),Performance Contractors Inc,36821,0,36821
"Kennedy, John",(R),Bollinger Shipyards,36800,0,36800
"Kennedy, John",(R),Will-Drill Resources,35750,0,35750
"Kennedy, John",(R),Corporate Capital LLC,35600,0,35600
"Kennedy, John",(R),Amedisys Inc,35210,30000,5210
"Kennedy, John",(R),Cajun Industries,35100,0,35100
"Kennedy, John",(R),Hri Properties,35033,0,35033
"Kennedy, John",(R),Turner Industries,34950,0,34950
"Kennedy, John",(R),Berkshire Hathaway,34831,17500,17331
"Kennedy, John",(R),Latham & Watkins,34400,0,34400
"Kennedy, John",(R),Port Aggregates Inc,32600,0,32600
"Kennedy, John",(R),Lamar Advertising,32000,5000,27000
"Kennedy, John",(R),UBS AG,31400,25000,6400
"Kennedy, John",(R),Tellurian Inc,31325,5000,26325
"Kennedy, John",(R),Fishman Haygood LLP,30500,0,30500
"Kennedy, John",(R),Roy O Martin Lumber,30200,0,30200
"Kennedy, John",(R),Latter & Blum,29800,0,29800
"Kennedy, John",(R),Lamarque Motor Co,29100,0,29100
"Kennedy, John",(R),LHC Group,29000,7000,22000
"Kennedy, John",(R),Lwcc,28499,0,28499
"Kennedy, John",(R),D&J Construction,28490,0,28490
"Kennedy, John",(R),Crest Industries,28000,0,28000
"Kennedy, John",(R),Kinsey Interests,27950,0,27950
"Kennedy, John",(R),ISC Constructors,27300,0,27300
"Kennedy, John",(R),Collier Investments,27100,0,27100
"Kennedy, John",(R),Offshore Liftboats LLC,27100,0,27100
"Kennedy, John",(R),Versabar Inc,26910,0,26910
"Kennedy, John",(R),Edison Chouest Offshore,26800,0,26800
"Kennedy, John",(R),Foley & Judell,25800,0,25800
"Kennedy, John",(R),Family Eye Care Assoc,25400,0,25400
"Kennedy, John",(R),Fran Oil,25400,0,25400
"Kennedy, John",(R),Marathon Petroleum,25120,25000,120
"Kennedy, John",(R),B&G Food Enterprises,24500,0,24500
"Kennedy, John",(R),Pellerin Laundry Machine Sales,24500,0,24500
"Kennedy, John",(R),Davison Transport,24300,0,24300
"Kennedy, John",(R),Harvey Gulf International Marine,24300,0,24300
"Kennedy, John",(R),"Stone, Pigman et al",23950,0,23950
"Kennedy, John",(R),Fairfield Property Management,23800,0,23800
"Kennedy, John",(R),Lumen Technologies,23355,15500,7855
"Kennedy, John",(R),Builders Supply Co,22850,0,22850
"Kennedy, John",(R),Madden Contracting,22850,0,22850
"Kennedy, John",(R),Cajun Chef Products,22500,0,22500
"Kennedy, John",(R),Tulane University,22200,0,22200
"Kennedy, John",(R),Metro Aviation Inc,21800,0,21800
"Kennedy, John",(R),Woodward Design & Build,21800,0,21800
"Kennedy, John",(R),Courtesy Automotive,21700,0,21700
"Kennedy, John",(R),Gaubert Oil Co,21700,0,21700
"Kennedy, John",(R),Soil Stabilizers,21700,0,21700
"Kennedy, John",(R),Ul Coleman Companies,21700,0,21700
"Kennedy, John",(R),Barrister Global Services,21600,0,21600
"Kennedy, John",(R),Correct Care Inc,21600,0,21600
"Kennedy, John",(R),Hercules Transport,21500,0,21500
"Kennedy, John",(R),Blessey Marine Service,21200,13100,8100
"Kennedy, John",(R),Crosby Energy Services,21025,0,21025
"Kennedy, John",(R),Mortgage Bankers Assn,21000,21000,0
"Kennedy, John",(R),Adams & Reese,20900,12500,8400
"Kennedy, John",(R),McC Group,20900,0,20900
"Kennedy, John",(R),Acme Oysters,20700,0,20700
"Kennedy, John",(R),Major Equipment & Remediation Services,20500,0,20500
"Kennedy, John",(R),Chaffe McCall LLP,20450,0,20450
"Kennedy, John",(R),Tucker Property Management,20300,0,20300
"Kennedy, John",(R),Madden Construction,20250,0,20250
"Kennedy, John",(R),Northrop Grumman,20172,19000,1172
"Kennedy, John",(R),Deloitte LLP,20095,20000,95
"Kennedy, John",(R),United Parcel Service,20020,19500,520
"Kennedy, John",(R),Ghk Developments,20000,0,20000
"Kennedy, John",(R),Royal Honda,19900,0,19900
"Kennedy, John",(R),Barriere Construction,19800,0,19800
"Kennedy, John",(R),Capital One Financial,19515,18500,1015
"Kennedy, John",(R),Industrial Specialty,19300,0,19300
"Kennedy, John",(R),Kencoil Inc,19200,0,19200
"Kennedy, John",(R),Republic Beverage,19200,0,19200
"Kennedy, John",(R),Plexos Group,19100,0,19100
"Kennedy, John",(R),"Bernstein, Litowitz et al",19000,0,19000
"Kennedy, John",(R),Crosby Tugs,19000,0,19000
"Kennedy, John",(R),Larsen Intermodal Services,19000,0,19000
"Kennedy, John",(R),Leblanc Auto,19000,0,19000
"Kennedy, John",(R),"Linfield, Hunter & Junius",19000,0,19000
"Kennedy, John",(R),Louisiana Rice Mill LLC,19000,0,19000
"Kennedy, John",(R),Mallett Buildings,19000,0,19000
"Kennedy, John",(R),Pontchartrain Capital,19000,0,19000
"Kennedy, John",(R),Wampold Companies,19000,0,19000
"Kennedy, John",(R),Oats & Marino,18900,0,18900
"Kennedy, John",(R),Richardson Companies,18900,0,18900
"Kennedy, John",(R),Huval & Assoc,18600,0,18600
"Kennedy, John",(R),National Assn of Realtors,18500,18500,0
"Kennedy, John",(R),Star Service,18500,0,18500
"Kennedy, John",(R),Bank of Montgomery,18200,0,18200
"Kennedy, John",(R),Bass Ltd,18200,0,18200
"Kennedy, John",(R),"Cole, Evans & Peterson",18100,0,18100
"Kennedy, John",(R),Willis-Knighton Health System,18100,0,18100
"Kennedy, John",(R),Vintage Realty,17950,0,17950
"King, Angus",(I),General Dynamics,97650,41000,56650
"King, Angus",(I),JStreetPAC,88085,0,88085
"King, Angus",(I),Northrop Grumman,73300,42000,31300
"King, Angus",(I),Unum Group,38786,22500,16286
"King, Angus",(I),Lockheed Martin,38500,38500,0
"King, Angus",(I),Paloma Partners,37900,0,37900
"King, Angus",(I),League of Conservation Voters,33853,11999,21854
"King, Angus",(I),American Institute of CPAs,31000,31000,0
"King, Angus",(I),Alphabet Inc,30800,20000,10800
"King, Angus",(I),American Hotel & Lodging Assn,30000,30000,0
"King, Angus",(I),Comcast Corp,27650,25000,2650
"King, Angus",(I),"Bernstein, Shur et al",27025,0,27025
"King, Angus",(I),Cooney & Conway,27000,0,27000
"King, Angus",(I),RTX Corp,26650,14000,12650
"King, Angus",(I),AT&T Inc,26000,26000,0
"King, Angus",(I),American Assn for Justice,25000,25000,0
"King, Angus",(I),Democracy Engine,23425,0,23425
"King, Angus",(I),Honeywell International,22500,22500,0
"King, Angus",(I),New York Life Insurance,22500,22500,0
"King, Angus",(I),Charter Communications,22000,22000,0
"King, Angus",(I),T-Mobile USA,21000,21000,0
"King, Angus",(I),International Franchise Assn,20000,20000,0
"King, Angus",(I),Telephone & Data Systems Inc,19800,9000,10800
"King, Angus",(I),Microsoft Corp,19100,18000,1100
"King, Angus",(I),Spectrum Medical Group,18250,0,18250
"King, Angus",(I),Boeing Co,18000,17500,500
"King, Angus",(I),UBS AG,17700,15000,2700
"King, Angus",(I),Cardinal Health,17500,17500,0
"King, Angus",(I),Sun Life Financial,17400,15400,2000
"King, Angus",(I),Bowdoin College,17175,0,17175
"King, Angus",(I),NextEra Energy,17000,17000,0
"King, Angus",(I),Drummond Woodsum,16950,0,16950
"King, Angus",(I),Lee Auto Mall,16500,0,16500
"King, Angus",(I),America's Credit Unions,16000,15000,1000
"King, Angus",(I),National Multifamily Housing Council,16000,16000,0
"King, Angus",(I),Fidelity Investments,15500,14500,1000
"King, Angus",(I),International Brotherhood of Electrical Workers,15000,15000,0
"King, Angus",(I),Laborers Union,15000,15000,0
"King, Angus",(I),Plumbers/Pipefitters Union,15000,15000,0
"King, Angus",(I),Mortgage Bankers Assn,14500,14500,0
"King, Angus",(I),State of Maine,14450,0,14450
"King, Angus",(I),Independent Community Bankers of America,14000,14000,0
"King, Angus",(I),National Assn of Realtors,14000,14000,0
"King, Angus",(I),Texas Instruments,13700,10000,3700
"King, Angus",(I),Dakota Prairie PAC,13691,13691,0
"King, Angus",(I),International Paper,13500,13500,0
"King, Angus",(I),Walmart Inc,13500,13500,0
"King, Angus",(I),Geiger,13400,0,13400
"King, Angus",(I),Anthem Inc,13100,10000,3100
"King, Angus",(I),Jay Cashman Inc,13100,0,13100
"King, Angus",(I),Procter & Gamble,13000,11000,2000
"King, Angus",(I),Bad Robot Productions,12800,0,12800
"King, Angus",(I),Jackson Laboratory,12775,0,12775
"King, Angus",(I),National Air Traffic Controllers Assn,12500,12500,0
"King, Angus",(I),Huntington Ingalls Industries,12000,12000,0
"King, Angus",(I),SMART Transportation Division,12000,12000,0
"King, Angus",(I),Aetna Inc,11800,0,11800
"King, Angus",(I),American Bankers Assn,11250,10000,1250
"King, Angus",(I),Capitol Counsel,11200,0,11200
"King, Angus",(I),Atlas Holdings,11000,0,11000
"King, Angus",(I),Deloitte LLP,11000,10000,1000
"King, Angus",(I),National Assn of Broadcasters,11000,8500,2500
"King, Angus",(I),Verrill Dana Llp,10950,0,10950
"King, Angus",(I),Allogene,10800,0,10800
"King, Angus",(I),Atlas Energy,10800,0,10800
"King, Angus",(I),BeLLCo Capital LLC,10800,0,10800
"King, Angus",(I),Carnival Corp,10800,0,10800
"King, Angus",(I),Elevation Partners,10800,0,10800
"King, Angus",(I),"English, Munger & Rice",10800,0,10800
"King, Angus",(I),Harraseeket Inn,10800,0,10800
"King, Angus",(I),"Keefe, Keefe & Unsell",10800,0,10800
"King, Angus",(I),Simmons Hanly Conroy,10800,0,10800
"King, Angus",(I),"Welsh, Carson et al",10800,0,10800
"King, Angus",(I),"Williams, Hart et al",10800,0,10800
"King, Angus",(I),Goulston & Storrs,10550,0,10550
"King, Angus",(I),Verizon Communications,10500,10500,0
"King, Angus",(I),American Council of Life Insurers,10000,10000,0
"King, Angus",(I),American Federation of State/Cnty/Munic Employees,10000,10000,0
"King, Angus",(I),American Federation of Teachers,10000,10000,0
"King, Angus",(I),American Wind Energy Assn,10000,10000,0
"King, Angus",(I),Association for Advanced Life Underwriting,10000,10000,0
"King, Angus",(I),Blue Hen PAC,10000,10000,0
"King, Angus",(I),Ernst & Young,10000,10000,0
"King, Angus",(I),Fearless for the People,10000,10000,0
"King, Angus",(I),Global Capital,10000,0,10000
"King, Angus",(I),Hoosiers First PAC,10000,10000,0
"King, Angus",(I),Impact (Schumer),10000,10000,0
"King, Angus",(I),International Assn of Fire Fighters,10000,10000,0
"King, Angus",(I),M-PAC,10000,10000,0
"King, Angus",(I),Machinists/Aerospace Workers Union,10000,10000,0
"King, Angus",(I),Midwest Values PAC,10000,10000,0
"King, Angus",(I),National Active & Retired Federal Employees Assn,10000,10000,0
"King, Angus",(I),National Assn of Insurance & Financial Advisors,10000,10000,0
"King, Angus",(I),National Education Assn,10000,10000,0
"King, Angus",(I),National Potato Council,10000,10000,0
"King, Angus",(I),Nutmeg PAC,10000,10000,0
"King, Angus",(I),Operating Engineers Union,10000,10000,0
"King, Angus",(I),PAC for a Level Playing Field,10000,10000,0
"King, Angus",(I),Prairie PAC,10000,10000,0
"King, Angus",(I),SpaceX,10000,10000,0
"Klobuchar, Amy",(D),Walt Disney Co,91501,18250,73251
"Klobuchar, Amy",(D),University of Minnesota,87987,0,87987
"Klobuchar, Amy",(D),Delta Air Lines,81279,25000,56279
"Klobuchar, Amy",(D),"Wachtell, Lipton et al",75959,0,75959
"Klobuchar, Amy",(D),Comcast Corp,61277,29500,31777
"Klobuchar, Amy",(D),Dorsey & Whitney,60718,4250,56468
"Klobuchar, Amy",(D),Microsoft Corp,54200,20000,34200
"Klobuchar, Amy",(D),Cargill Inc,53655,11000,42655
"Klobuchar, Amy",(D),General Mills,52728,6500,46228
"Klobuchar, Amy",(D),US Bancorp,50993,9000,41993
"Klobuchar, Amy",(D),Starkey Hearing Technologies,48110,1000,47110
"Klobuchar, Amy",(D),Target Corp,47434,17000,30434
"Klobuchar, Amy",(D),Morgan Stanley,46785,10000,36785
"Klobuchar, Amy",(D),Land O'Lakes,46658,9000,37658
"Klobuchar, Amy",(D),NAU Country Insurance,46575,0,46575
"Klobuchar, Amy",(D),Lockridge Grindal Nauen Pllp,45548,8998,36550
"Klobuchar, Amy",(D),Womencount PAC,44156,6,44150
"Klobuchar, Amy",(D),Best Buy,44154,12500,31654
"Klobuchar, Amy",(D),Xcel Energy,43135,13000,30135
"Klobuchar, Amy",(D),Centerview Partners,42400,0,42400
"Klobuchar, Amy",(D),Medtronic Inc,42276,18000,24276
"Klobuchar, Amy",(D),Alphabet Inc,41922,26000,15922
"Klobuchar, Amy",(D),Ecolab Inc,40500,9000,31500
"Klobuchar, Amy",(D),UnitedHealth Group,38264,7500,30764
"Klobuchar, Amy",(D),Garden Homes,37525,0,37525
"Klobuchar, Amy",(D),Robins Kaplan LLP,36950,6000,30950
"Klobuchar, Amy",(D),Centerbridge Partners,35600,0,35600
"Klobuchar, Amy",(D),CSM Corp,35600,0,35600
"Klobuchar, Amy",(D),Marriott International,34700,17500,17200
"Klobuchar, Amy",(D),Carsey-Werner LLC,34200,0,34200
"Klobuchar, Amy",(D),Pohlad Companies,34000,0,34000
"Klobuchar, Amy",(D),Wells Fargo,32499,3500,28999
"Klobuchar, Amy",(D),Apollo Global Management,31226,7500,23726
"Klobuchar, Amy",(D),Air Line Pilots Assn,31005,30000,1005
"Klobuchar, Amy",(D),Directors Guild of America,30800,15000,15800
"Klobuchar, Amy",(D),Honeywell International,30698,28000,2698
"Klobuchar, Amy",(D),International Brotherhood of Electrical Workers,30306,30000,306
"Klobuchar, Amy",(D),Carpenters & Joiners Union,30000,30000,0
"Klobuchar, Amy",(D),National Beer Wholesalers Assn,30000,30000,0
"Klobuchar, Amy",(D),Painters & Allied Trades Union,30000,30000,0
"Klobuchar, Amy",(D),Southern Minn Beet Sugar Co-Op,30000,30000,0
"Klobuchar, Amy",(D),3M Co,29034,10000,19034
"Klobuchar, Amy",(D),Gracie Films,28600,0,28600
"Klobuchar, Amy",(D),Heartland Realty Investors,28500,0,28500
"Klobuchar, Amy",(D),"Sheet Metal, Air, Rail & Transportation Union",28500,28500,0
"Klobuchar, Amy",(D),Shakopee Mdewakanton Sioux Community,28100,0,28100
"Klobuchar, Amy",(D),Yelp Inc,27800,4400,23400
"Klobuchar, Amy",(D),American Hotel & Lodging Assn,27400,27400,0
"Klobuchar, Amy",(D),Medica,27232,0,27232
"Klobuchar, Amy",(D),National Air Traffic Controllers Assn,27000,27000,0
"Klobuchar, Amy",(D),National Assn of Broadcasters,26500,26000,500
"Klobuchar, Amy",(D),Mayo Clinic,26447,0,26447
"Klobuchar, Amy",(D),Minnesota Vikings,26400,0,26400
"Klobuchar, Amy",(D),Harvard University,26300,0,26300
"Klobuchar, Amy",(D),Deloitte LLP,26183,20000,6183
"Klobuchar, Amy",(D),UBS AG,26122,25000,1122
"Klobuchar, Amy",(D),Ford Motor Co,26085,15000,11085
"Klobuchar, Amy",(D),Allied Wallet,25800,0,25800
"Klobuchar, Amy",(D),Polaris Industries,25660,2500,23160
"Klobuchar, Amy",(D),State of Minnesota,25305,0,25305
"Klobuchar, Amy",(D),American Assn for Justice,25000,25000,0
"Klobuchar, Amy",(D),NCTA The Internet & Television Assn,25000,23500,1500
"Klobuchar, Amy",(D),Operating Engineers Union,25000,25000,0
"Klobuchar, Amy",(D),Hilton Worldwide,24563,15000,9563
"Klobuchar, Amy",(D),Blue Cross/Blue Shield,24544,8000,16544
"Klobuchar, Amy",(D),"Faegre, Drinker et al",24375,9000,15375
"Klobuchar, Amy",(D),WilmerHale LLP,24215,0,24215
"Klobuchar, Amy",(D),Carval Investors,23600,0,23600
"Klobuchar, Amy",(D),Key Investments,23300,0,23300
"Klobuchar, Amy",(D),Michael Stars Inc,23249,0,23249
"Klobuchar, Amy",(D),Carlson Companies,22560,0,22560
"Klobuchar, Amy",(D),Ironworkers Union,22500,22500,0
"Klobuchar, Amy",(D),Laborers Union,22500,22500,0
"Klobuchar, Amy",(D),NTCA/Rural Broadband Assn,22500,22500,0
"Klobuchar, Amy",(D),Home Depot,22033,21500,533
"Klobuchar, Amy",(D),Thrivent Financial,21939,13333,8606
"Klobuchar, Amy",(D),United Talent Agency,21625,0,21625
"Klobuchar, Amy",(D),American Crystal Sugar,21350,20000,1350
"Klobuchar, Amy",(D),AT&T Inc,20870,5700,15170
"Klobuchar, Amy",(D),Infinite Campus,20400,0,20400
"Klobuchar, Amy",(D),Berkshire Hathaway,20310,17000,3310
"Klobuchar, Amy",(D),National Rural Electric Cooperative Assn,20060,20000,60
"Klobuchar, Amy",(D),Walmart Inc,19632,14000,5632
"Klobuchar, Amy",(D),Abbott Laboratories,19482,15000,4482
"Klobuchar, Amy",(D),Planned Parenthood,19450,5000,14450
"Klobuchar, Amy",(D),Greenberg Traurig LLP,19073,2500,16573
"Klobuchar, Amy",(D),Gray Plant Mooty,19056,6868,12188
"Klobuchar, Amy",(D),Goldman Sachs,18700,2000,16700
"Klobuchar, Amy",(D),General Motors,18010,18000,10
"Klobuchar, Amy",(D),American Academy of Neurology,18000,18000,0
"Klobuchar, Amy",(D),League of Conservation Voters,18000,4500,13500
"Klobuchar, Amy",(D),"Paul, Weiss et al",17875,0,17875
"Klobuchar, Amy",(D),International Assn of Fire Fighters,17500,17500,0
"Klobuchar, Amy",(D),Fredrikson & Byron,17484,0,17484
"Klobuchar, Amy",(D),Stinson LLP,17425,0,17425
"Klobuchar, Amy",(D),Procter & Gamble,17400,10000,7400
"Klobuchar, Amy",(D),Poet LLC,17300,10000,7300
"Klobuchar, Amy",(D),Oracle Corp,17001,3500,13501
"Klobuchar, Amy",(D),Securian Financial Group,16835,7600,9235
"Klobuchar, Amy",(D),Facebook Inc,16500,7500,9000
"Lankford, James",(R),Blue Cross/Blue Shield,53500,53000,500
"Lankford, James",(R),Honeywell International,51500,36000,15500
"Lankford, James",(R),Ernst & Young,46250,42500,3750
"Lankford, James",(R),Cox Enterprises,44500,41000,3500
"Lankford, James",(R),Union Pacific Corp,40000,40000,0
"Lankford, James",(R),Devon Energy,39200,10000,29200
"Lankford, James",(R),United Parcel Service,34647,34647,0
"Lankford, James",(R),Chickasaw Nation,34383,0,34383
"Lankford, James",(R),AT&T Inc,32500,31000,1500
"Lankford, James",(R),New York Life Insurance,32000,30000,2000
"Lankford, James",(R),Berkshire Hathaway,31900,26500,5400
"Lankford, James",(R),Northrop Grumman,31525,31500,25
"Lankford, James",(R),Koch Inc,30800,20000,10800
"Lankford, James",(R),Koch Industries,30800,20000,10800
"Lankford, James",(R),Energy Transfer Partners,30600,5000,25600
"Lankford, James",(R),BancFirst,27350,1500,25850
"Lankford, James",(R),American Optometric Assn,27250,26500,750
"Lankford, James",(R),Cherokee Nation,25400,0,25400
"Lankford, James",(R),Comcast Corp,25000,25000,0
"Lankford, James",(R),FedEx Corp,25000,25000,0
"Lankford, James",(R),American Assn of Orthopaedic Surgeons,24500,24500,0
"Lankford, James",(R),Pelco Structural,24112,0,24112
"Lankford, James",(R),American Bankers Assn,23750,17500,6250
"Lankford, James",(R),Ward Petroleum,23600,0,23600
"Lankford, James",(R),Senior Star,22600,0,22600
"Lankford, James",(R),International Paper,22500,22500,0
"Lankford, James",(R),National Assn of Chemical Distributors,22500,22500,0
"Lankford, James",(R),Valero Energy,22500,22500,0
"Lankford, James",(R),Williams Companies,22500,20500,2000
"Lankford, James",(R),Oklahoma State University,21800,0,21800
"Lankford, James",(R),Mathena Inc,21600,0,21600
"Lankford, James",(R),Amgen Inc,21500,21000,500
"Lankford, James",(R),Lockheed Martin,21500,21500,0
"Lankford, James",(R),MANHATTAN ROAD & BRIDGE,21400,0,21400
"Lankford, James",(R),L3Harris Technologies,20500,20500,0
"Lankford, James",(R),Charter Communications,20000,20000,0
"Lankford, James",(R),Dakota PAC,20000,20000,0
"Lankford, James",(R),Freedom Fund,20000,20000,0
"Lankford, James",(R),Home Depot,20000,20000,0
"Lankford, James",(R),National Active & Retired Federal Employees Assn,20000,20000,0
"Lankford, James",(R),National Assn of Realtors,20000,20000,0
"Lankford, James",(R),Reclaim America PAC,20000,20000,0
"Lankford, James",(R),Rooney Holdings,19600,0,19600
"Lankford, James",(R),Goldman Sachs,19500,18500,1000
"Lankford, James",(R),Hanor Co,19500,0,19500
"Lankford, James",(R),Air Line Pilots Assn,19000,19000,0
"Lankford, James",(R),General Dynamics,19000,19000,0
"Lankford, James",(R),Walmart Inc,18890,18500,390
"Lankford, James",(R),Williams & Jensen,18883,1000,17883
"Lankford, James",(R),Marathon Petroleum,18500,18500,0
"Lankford, James",(R),American Seniors Housing Assn,17500,17500,0
"Lankford, James",(R),Deloitte LLP,17500,17500,0
"Lankford, James",(R),Pinnacle West Capital,17000,17000,0
"Lankford, James",(R),Oklahoma Heart Hospital,16959,0,16959
"Lankford, James",(R),Elmbrook Management,16400,0,16400
"Lankford, James",(R),Gaming Capital Group,16200,0,16200
"Lankford, James",(R),Hall Capital Partners,16200,0,16200
"Lankford, James",(R),Legacy Bank,16200,0,16200
"Lankford, James",(R),Action Safety Supply,16050,0,16050
"Lankford, James",(R),Aircraft Owners & Pilots Assn,16000,16000,0
"Lankford, James",(R),American Airlines,16000,15000,1000
"Lankford, James",(R),Enterprise Holdings,16000,16000,0
"Lankford, James",(R),Spirit Aerosystems,16000,16000,0
"Lankford, James",(R),OGE Energy,15550,9100,6450
"Lankford, James",(R),Free State PAC,15000,15000,0
"Lankford, James",(R),Mortgage Bankers Assn,15000,15000,0
"Lankford, James",(R),UBS Americas,15000,15000,0
"Lankford, James",(R),American Fidelity Corp,14520,7400,7120
"Lankford, James",(R),Altria Group,14500,14500,0
"Lankford, James",(R),American Dental Assn,14500,14500,0
"Lankford, James",(R),Grant Thornton LLP,14500,14500,0
"Lankford, James",(R),JPMorgan Chase & Co,14500,14000,500
"Lankford, James",(R),NextEra Energy,14000,14000,0
"Lankford, James",(R),Bluescape Resources,13800,0,13800
"Lankford, James",(R),American Institute of CPAs,13500,13500,0
"Lankford, James",(R),Siemens Corp,13250,8750,4500
"Lankford, James",(R),Boesch & Co,12850,0,12850
"Lankford, James",(R),Exxon Mobil,12775,12500,275
"Lankford, James",(R),Arkansas for Leadership,12500,12500,0
"Lankford, James",(R),Google Inc,12500,12500,0
"Lankford, James",(R),Peter Norbeck Leadership PAC,12500,12500,0
"Lankford, James",(R),Shakopee Mdewakanton Sioux Community,12100,0,12100
"Lankford, James",(R),American Health Care Assn,12000,12000,0
"Lankford, James",(R),Federal Aviation Admin Managers Assn,12000,12000,0
"Lankford, James",(R),Melton Truck Lines,12000,0,12000
"Lankford, James",(R),National Roofing Contractors Assn,12000,12000,0
"Lankford, James",(R),Arrow Oil & Gas,11700,0,11700
"Lankford, James",(R),BP,11500,11500,0
"Lankford, James",(R),General Motors,11500,10000,1500
"Lankford, James",(R),Leidos Inc,11500,11500,0
"Lankford, James",(R),Seaboard Corp,11500,11500,0
"Lankford, James",(R),Harrison Gypsum,11400,0,11400
"Lankford, James",(R),Chesapeake Energy,11325,10000,1325
"Lankford, James",(R),Blackstone Group,11200,0,11200
"Lankford, James",(R),Capital Group Companies,11200,4500,6700
"Lankford, James",(R),Huntington Ingalls Industries,11000,11000,0
"Lankford, James",(R),Friess Assoc,10800,0,10800
"Lankford, James",(R),Heritage Foundation,10800,0,10800
"Lankford, James",(R),Mathis Brothers Furniture,10800,0,10800
"Lankford, James",(R),Midfirst Bank,10800,0,10800
"Leahy, Patrick",(D),Lockheed Martin,93373,27500,65873
"Leahy, Patrick",(D),Boeing Co,88218,47500,40718
"Leahy, Patrick",(D),Law Offices of Peter G Angelos,71400,0,71400
"Leahy, Patrick",(D),Comcast Corp,65235,38500,26735
"Leahy, Patrick",(D),Microsoft Corp,63500,35000,28500
"Leahy, Patrick",(D),"Akin, Gump et al",56950,8825,48125
"Leahy, Patrick",(D),Google Inc,51629,40500,11129
"Leahy, Patrick",(D),Girardi & Keese,51000,0,51000
"Leahy, Patrick",(D),General Dynamics,50838,43000,7838
"Leahy, Patrick",(D),Burton Snowboards,50800,0,50800
"Leahy, Patrick",(D),DISH Network,49500,20500,29000
"Leahy, Patrick",(D),AT&T Inc,48337,35500,12837
"Leahy, Patrick",(D),"Cotchett, Pitre & McCarthy",47400,0,47400
"Leahy, Patrick",(D),MacAndrews & Forbes,46400,25000,21400
"Leahy, Patrick",(D),JStreetPAC,44168,3750,40418
"Leahy, Patrick",(D),National Assn of Broadcasters,41350,35000,6350
"Leahy, Patrick",(D),Deloitte LLP,40000,40000,0
"Leahy, Patrick",(D),American Assn for Justice,39000,39000,0
"Leahy, Patrick",(D),Walt Disney Co,37770,20000,17770
"Leahy, Patrick",(D),National Beer Wholesalers Assn,37500,37500,0
"Leahy, Patrick",(D),Honeywell International,36500,36500,0
"Leahy, Patrick",(D),NCTA The Internet & Television Assn,35500,35500,0
"Leahy, Patrick",(D),WilmerHale Llp,34222,0,34222
"Leahy, Patrick",(D),Northrop Grumman,34102,34000,102
"Leahy, Patrick",(D),Laborers Union,33500,33500,0
"Leahy, Patrick",(D),"Sheet Metal, Air, Rail & Transportation Union",33000,33000,0
"Leahy, Patrick",(D),Pfizer Inc,31000,31000,0
"Leahy, Patrick",(D),Duberstein Group,30700,0,30700
"Leahy, Patrick",(D),American Federation of State/Cnty/Munic Employees,30500,30500,0
"Leahy, Patrick",(D),International Brotherhood of Electrical Workers,30000,30000,0
"Leahy, Patrick",(D),Wine & Spirits Wholesalers of America,30000,30000,0
"Leahy, Patrick",(D),"Skadden, Arps et al",29865,0,29865
"Leahy, Patrick",(D),American Institute of CPAs,29500,29500,0
"Leahy, Patrick",(D),Huntington Ingalls Industries,29000,29000,0
"Leahy, Patrick",(D),National Fraternal Order of Police,27500,27500,0
"Leahy, Patrick",(D),Verizon Communications,27013,23500,3513
"Leahy, Patrick",(D),RTX Corp,25838,24500,1338
"Leahy, Patrick",(D),Soros Fund Management,25400,0,25400
"Leahy, Patrick",(D),Putala Strategies,24900,0,24900
"Leahy, Patrick",(D),Major League Baseball Commissioner's Ofc,24000,24000,0
"Leahy, Patrick",(D),Mortgage Bankers Assn,23000,22500,500
"Leahy, Patrick",(D),Bergman Draper Oslund,22900,0,22900
"Leahy, Patrick",(D),Directors Guild of America,22500,17500,5000
"Leahy, Patrick",(D),Van Scoyoc Assoc,21872,1459,20413
"Leahy, Patrick",(D),DreamWorks SKG,21700,0,21700
"Leahy, Patrick",(D),Newpage Corp,21150,0,21150
"Leahy, Patrick",(D),Franklin Square Group,20800,0,20800
"Leahy, Patrick",(D),Venable LLP,20600,5500,15100
"Leahy, Patrick",(D),Institute of International Education,20225,0,20225
"Leahy, Patrick",(D),Common Ground PAC,20000,20000,0
"Leahy, Patrick",(D),GE Aerospace,20000,20000,0
"Leahy, Patrick",(D),Summit Foundation,19550,0,19550
"Leahy, Patrick",(D),General Electric,19500,15500,4000
"Leahy, Patrick",(D),iHeartMedia Inc,19500,19500,0
"Leahy, Patrick",(D),AFLAC Inc,19000,19000,0
"Leahy, Patrick",(D),National Assn of Realtors,19000,19000,0
"Leahy, Patrick",(D),Children's Research & Education Institute,18700,0,18700
"Leahy, Patrick",(D),National Amusements Inc,18650,12000,6650
"Leahy, Patrick",(D),DLA Piper,18503,13500,5003
"Leahy, Patrick",(D),Falconwood Corp,18300,0,18300
"Leahy, Patrick",(D),Holland & Knight,18100,16000,2100
"Leahy, Patrick",(D),Facebook Inc,17902,11500,6402
"Leahy, Patrick",(D),Proskauer Rose,17900,0,17900
"Leahy, Patrick",(D),Amazon.com,17720,14500,3220
"Leahy, Patrick",(D),International Assn of Fire Fighters,17500,17500,0
"Leahy, Patrick",(D),Sony Corp,17185,10000,7185
"Leahy, Patrick",(D),Alston & Bird,17000,14250,2750
"Leahy, Patrick",(D),Merck & Co,17000,17000,0
"Leahy, Patrick",(D),National Air Traffic Controllers Assn,17000,17000,0
"Leahy, Patrick",(D),Main Street Landing,16500,0,16500
"Leahy, Patrick",(D),Woodbranch Investments,16200,0,16200
"Leahy, Patrick",(D),Vail Resorts,16000,16000,0
"Leahy, Patrick",(D),Polsinelli PC,15750,12000,3750
"Leahy, Patrick",(D),Bank of America,15578,15000,578
"Leahy, Patrick",(D),Bill & Melinda Gates Foundation,15500,0,15500
"Leahy, Patrick",(D),Manzanita Capital,15400,0,15400
"Leahy, Patrick",(D),Podesta Group,15300,0,15300
"Leahy, Patrick",(D),Vietnam Assistance,15200,0,15200
"Leahy, Patrick",(D),America Works,15000,15000,0
"Leahy, Patrick",(D),American Crystal Sugar,15000,15000,0
"Leahy, Patrick",(D),American Hotel & Lodging Assn,15000,15000,0
"Leahy, Patrick",(D),Ej Global LLC,15000,0,15000
"Leahy, Patrick",(D),Follow the North Star Fund,15000,15000,0
"Leahy, Patrick",(D),Forward Together PAC,15000,15000,0
"Leahy, Patrick",(D),General Atomics,15000,15000,0
"Leahy, Patrick",(D),Hawaii PAC,15000,15000,0
"Leahy, Patrick",(D),Home Depot,15000,15000,0
"Leahy, Patrick",(D),Ironworkers Union,15000,15000,0
"Leahy, Patrick",(D),Keystone America PAC,15000,15000,0
"Leahy, Patrick",(D),Oceans PAC,15000,15000,0
"Leahy, Patrick",(D),Union Pacific Corp,15000,15000,0
"Leahy, Patrick",(D),Victory Now PAC,15000,15000,0
"Leahy, Patrick",(D),Bayer Corp,14136,9500,4636
"Leahy, Patrick",(D),Universal Music Group,13500,6500,7000
"Leahy, Patrick",(D),US Travel Assn,13500,13500,0
"Leahy, Patrick",(D),American Dental Assn,12500,12500,0
"Leahy, Patrick",(D),Baker & Hostetler,12500,10000,2500
"Leahy, Patrick",(D),Kaminsky Putala Public Relations,12400,0,12400
"Leahy, Patrick",(D),Greenberg Traurig LLP,12250,9500,2750
"Leahy, Patrick",(D),King & Spalding,12250,7000,5250
"Lee, Mike",(R),Club for Growth,352132,0,352132
"Lee, Mike",(R),Senate Conservatives Fund,162507,5500,157007
"Lee, Mike",(R),Kirkham Motorsports,111200,0,111200
"Lee, Mike",(R),"Pachulski, Stang et al",87400,0,87400
"Lee, Mike",(R),Sullivan & Cromwell,82191,0,82191
"Lee, Mike",(R),Uline Inc,78800,0,78800
"Lee, Mike",(R),Charter Communications,77400,44000,33400
"Lee, Mike",(R),Edge Creek,76600,0,76600
"Lee, Mike",(R),Microsoft Corp,67450,38000,29450
"Lee, Mike",(R),Gallery Furniture,64800,0,64800
"Lee, Mike",(R),Arizona Diamondbacks/Datatel Inc,54000,0,54000
"Lee, Mike",(R),Braman Motorcars,52000,0,52000
"Lee, Mike",(R),Comcast Corp,51600,28500,23100
"Lee, Mike",(R),KKR & Co,50360,13000,37360
"Lee, Mike",(R),Baker Hughes Inc,45900,0,45900
"Lee, Mike",(R),Cinemark USA,45800,0,45800
"Lee, Mike",(R),AT&T Inc,45050,45000,50
"Lee, Mike",(R),Ocean Star International,43200,0,43200
"Lee, Mike",(R),NorPAC,42800,0,42800
"Lee, Mike",(R),Humanscale Corp,37800,0,37800
"Lee, Mike",(R),Union Pacific Corp,37500,37500,0
"Lee, Mike",(R),Jedfam Group,37000,0,37000
"Lee, Mike",(R),CSX Corp,35000,35000,0
"Lee, Mike",(R),GEO Group,35000,15000,20000
"Lee, Mike",(R),National Assn of Broadcasters,34500,34500,0
"Lee, Mike",(R),Alphabet Inc,32700,13500,19200
"Lee, Mike",(R),New Vernon Capital,32400,0,32400
"Lee, Mike",(R),Platte River Ventures,32400,0,32400
"Lee, Mike",(R),Mary Kay Inc,32000,0,32000
"Lee, Mike",(R),Northrop Grumman,31550,29000,2550
"Lee, Mike",(R),Stewart & Stevenson,31200,0,31200
"Lee, Mike",(R),iHeartMedia Inc,30500,30500,0
"Lee, Mike",(R),Norfolk Southern,30000,30000,0
"Lee, Mike",(R),Baylor University,29700,0,29700
"Lee, Mike",(R),Sequoia Capital,29700,0,29700
"Lee, Mike",(R),Richard Collins Enterprises,29500,0,29500
"Lee, Mike",(R),Kirkland & Ellis,29400,0,29400
"Lee, Mike",(R),Yelp Inc,28700,10000,18700
"Lee, Mike",(R),National Beer Wholesalers Assn,28500,28500,0
"Lee, Mike",(R),NCTA The Internet & Television Assn,28000,28000,0
"Lee, Mike",(R),Berkshire Hathaway,27913,27500,413
"Lee, Mike",(R),Deason Capital Services,27000,0,27000
"Lee, Mike",(R),Golden Age Farm,26500,0,26500
"Lee, Mike",(R),AG Hill Partners,26400,0,26400
"Lee, Mike",(R),Tennessee Industrial Electronics,26400,0,26400
"Lee, Mike",(R),Cigna Corp,26000,25000,1000
"Lee, Mike",(R),Koch Inc,25800,15000,10800
"Lee, Mike",(R),Um Holdings,25800,0,25800
"Lee, Mike",(R),Gelclen Keller Capital,24300,0,24300
"Lee, Mike",(R),Sinclair Companies,23900,0,23900
"Lee, Mike",(R),Chevron Corp,22875,10000,12875
"Lee, Mike",(R),"Brownstein, Hyatt et al",22500,6500,16000
"Lee, Mike",(R),Arizona Diamondbacks,21600,0,21600
"Lee, Mike",(R),Chandler Management,21600,0,21600
"Lee, Mike",(R),Rayes Inc,21600,0,21600
"Lee, Mike",(R),Traditum Group,21600,0,21600
"Lee, Mike",(R),LPL Investment Group,21200,0,21200
"Lee, Mike",(R),Prescott Investors,21200,0,21200
"Lee, Mike",(R),T-Mobile USA,21000,21000,0
"Lee, Mike",(R),Doterra International,20500,0,20500
"Lee, Mike",(R),Peck Madigan Jones,20200,0,20200
"Lee, Mike",(R),Amazon.com,20027,20000,27
"Lee, Mike",(R),Ariel Corp,20000,0,20000
"Lee, Mike",(R),McAllen Anesthesia Consultants,20000,0,20000
"Lee, Mike",(R),Yacktman Asset Management,20000,0,20000
"Lee, Mike",(R),Medquest Pharmacy,19800,0,19800
"Lee, Mike",(R),First Republic Bank,18900,0,18900
"Lee, Mike",(R),Delta Air Lines,18500,18500,0
"Lee, Mike",(R),Broe Group,18200,0,18200
"Lee, Mike",(R),Dutko Grayling,18100,0,18100
"Lee, Mike",(R),Riordan & McKinzie,18100,0,18100
"Lee, Mike",(R),Sidley Austin LLP,18100,5000,13100
"Lee, Mike",(R),American Bankers Assn,18000,18000,0
"Lee, Mike",(R),Andrews Kurth Kenyon LLP,17700,0,17700
"Lee, Mike",(R),American Dental Assn,17500,17500,0
"Lee, Mike",(R),American Institute of CPAs,17500,17500,0
"Lee, Mike",(R),Koch Industries,17500,17500,0
"Lee, Mike",(R),National Assn of Realtors,17500,17500,0
"Lee, Mike",(R),Valero Energy,17500,17500,0
"Lee, Mike",(R),PricewaterhouseCoopers,17000,13000,4000
"Lee, Mike",(R),Blackstone Group,16800,0,16800
"Lee, Mike",(R),Bernard Marcus Family Foundation,16200,0,16200
"Lee, Mike",(R),Crow Holdings,16200,0,16200
"Lee, Mike",(R),Enterprise Group,16200,0,16200
"Lee, Mike",(R),Fast Food Systems,16200,0,16200
"Lee, Mike",(R),GCG Partners,16200,0,16200
"Lee, Mike",(R),Glendon Todd Capital,16200,0,16200
"Lee, Mike",(R),Heavy Construction Systems Specialists,16200,0,16200
"Lee, Mike",(R),Inventory Management,16200,0,16200
"Lee, Mike",(R),Israel Analytics Consulting,16200,0,16200
"Lee, Mike",(R),MTV Networks,16200,0,16200
"Lee, Mike",(R),Postmates,16200,0,16200
"Lee, Mike",(R),Route One Investment,16200,0,16200
"Lee, Mike",(R),Wayne Minor Motor Sports,16200,0,16200
"Lee, Mike",(R),Woodvine Group,16200,0,16200
"Lee, Mike",(R),Walt Disney Co,16010,16000,10
"Lee, Mike",(R),Nu Skin Enterprises,16000,5000,11000
"Lee, Mike",(R),Shields & Co,16000,0,16000
"Lee, Mike",(R),Paul Rogers & Assoc,15750,0,15750
"Lee, Mike",(R),Headwaters Inc,15400,5000,10400
"Lujan, Ben Ray",(D),Democracy Engine,75268,0,75268
"Lujan, Ben Ray",(D),Votesane PAC,65500,0,65500
"Lujan, Ben Ray",(D),Democratic Senatorial Campaign Cmte,49600,49600,0
"Lujan, Ben Ray",(D),National Assn of Broadcasters,39600,15000,24600
"Lujan, Ben Ray",(D),University of New Mexico,35555,0,35555
"Lujan, Ben Ray",(D),Comcast Corp,34709,5000,29709
"Lujan, Ben Ray",(D),University of California,27093,0,27093
"Lujan, Ben Ray",(D),Alphabet Inc,26763,9000,17763
"Lujan, Ben Ray",(D),University of Southern California,26100,0,26100
"Lujan, Ben Ray",(D),Digidems PAC,24343,1943,22400
"Lujan, Ben Ray",(D),Centerbridge Partners,23400,0,23400
"Lujan, Ben Ray",(D),National Assn of Realtors,23177,19999,3178
"Lujan, Ben Ray",(D),"Akin, Gump et al",22067,5000,17067
"Lujan, Ben Ray",(D),End Citizens United,21250,10000,11250
"Lujan, Ben Ray",(D),NextEra Energy,20895,0,20895
"Lujan, Ben Ray",(D),Air Line Pilots Assn,20010,20000,10
"Lujan, Ben Ray",(D),"Kleiner, Perkins et al",19700,0,19700
"Lujan, Ben Ray",(D),National Education Assn,19644,19000,644
"Lujan, Ben Ray",(D),AT&T Inc,18590,6000,12590
"Lujan, Ben Ray",(D),Fresenius Medical Care,18530,0,18530
"Lujan, Ben Ray",(D),United for A Strong America,18200,7000,11200
"Lujan, Ben Ray",(D),US Dept of Energy,18092,0,18092
"Lujan, Ben Ray",(D),State of New Mexico,17154,0,17154
"Lujan, Ben Ray",(D),Medquest Pharmacy,16814,0,16814
"Lujan, Ben Ray",(D),Bain Capital,16800,0,16800
"Lujan, Ben Ray",(D),Home Depot,16763,15000,1763
"Lujan, Ben Ray",(D),Anywhere Real Estate,15700,0,15700
"Lujan, Ben Ray",(D),Pechanga Band of Luiseno Mission Indians,15608,0,15608
"Lujan, Ben Ray",(D),L&F Distributors,15600,0,15600
"Lujan, Ben Ray",(D),Yocha Dehe Wintun Nation,15600,0,15600
"Lujan, Ben Ray",(D),Puyallup Tribe of Indians,15500,0,15500
"Lujan, Ben Ray",(D),Walt Disney Co,15216,0,15216
"Lujan, Ben Ray",(D),International Brotherhood of Electrical Workers,15198,15000,198
"Lujan, Ben Ray",(D),United Food & Commercial Workers Union,15120,15000,120
"Lujan, Ben Ray",(D),American Assn for Justice,15000,15000,0
"Lujan, Ben Ray",(D),Carpenters & Joiners Union,15000,15000,0
"Lujan, Ben Ray",(D),International Assn of Fire Fighters,15000,15000,0
"Lujan, Ben Ray",(D),Mortgage Bankers Assn,15000,15000,0
"Lujan, Ben Ray",(D),National Active & Retired Federal Employees Assn,15000,15000,0
"Lujan, Ben Ray",(D),National Assn of Home Builders,15000,15000,0
"Lujan, Ben Ray",(D),National Auto Dealers Assn,15000,15000,0
"Lujan, Ben Ray",(D),National Multifamily Housing Council,15000,15000,0
"Lujan, Ben Ray",(D),Tunica-Biloxi Tribe of Louisiana,14700,0,14700
"Lujan, Ben Ray",(D),Council for a Livable World,14386,0,14386
"Lujan, Ben Ray",(D),Bueno Foods,14025,0,14025
"Lujan, Ben Ray",(D),Microsoft Corp,14015,5000,9015
"Lujan, Ben Ray",(D),National Indian Gaming Assn,13667,4500,9167
"Lujan, Ben Ray",(D),McT Industries,13475,0,13475
"Lujan, Ben Ray",(D),Poarch Band of Creek Indians,12800,0,12800
"Lujan, Ben Ray",(D),Intel Corp,12657,0,12657
"Lujan, Ben Ray",(D),American Dental Assn,12500,12500,0
"Lujan, Ben Ray",(D),Honeywell International,12289,5000,7289
"Lujan, Ben Ray",(D),Forbes Tate Partners,12200,0,12200
"Lujan, Ben Ray",(D),Facebook Inc,12127,0,12127
"Lujan, Ben Ray",(D),League of Conservation Voters,12118,8618,3500
"Lujan, Ben Ray",(D),American Federation of Teachers,12000,12000,0
"Lujan, Ben Ray",(D),Costco Wholesale,11552,0,11552
"Lujan, Ben Ray",(D),Patagonia Inc,11451,0,11451
"Lujan, Ben Ray",(D),Amblin Partners,11200,0,11200
"Lujan, Ben Ray",(D),Animas Foundation,11200,0,11200
"Lujan, Ben Ray",(D),Attorney & Counselor At Law,11200,0,11200
"Lujan, Ben Ray",(D),Bad Robot Productions,11200,0,11200
"Lujan, Ben Ray",(D),Cordoba Corp,11200,0,11200
"Lujan, Ben Ray",(D),DISH Network,11200,0,11200
"Lujan, Ben Ray",(D),Lone Pine Capital,11200,0,11200
"Lujan, Ben Ray",(D),Munoz & Co,11200,0,11200
"Lujan, Ben Ray",(D),Price Group,11200,0,11200
"Lujan, Ben Ray",(D),National Beer Wholesalers Assn,11000,11000,0
"Lujan, Ben Ray",(D),KPMG LLP,10917,7500,3417
"Lujan, Ben Ray",(D),Alsop Louie Partners,10890,0,10890
"Lujan, Ben Ray",(D),Mirram Group,10800,0,10800
"Lujan, Ben Ray",(D),Five & Dime General Stores,10725,0,10725
"Lujan, Ben Ray",(D),Chickasaw Nation,10610,0,10610
"Lujan, Ben Ray",(D),Choctaw Nation of Oklahoma,10600,0,10600
"Lujan, Ben Ray",(D),Loma Verde Properties,10600,0,10600
"Lujan, Ben Ray",(D),Snoqualmie Indian Tribe,10600,0,10600
"Lujan, Ben Ray",(D),"Brownstein, Hyatt et al",10580,0,10580
"Lujan, Ben Ray",(D),Teamsters Union,10568,10000,568
"Lujan, Ben Ray",(D),Cornerstone Government Affairs,10400,0,10400
"Lujan, Ben Ray",(D),Latino Victory Fund,10300,10000,300
"Lujan, Ben Ray",(D),Service Employees International Union,10260,5000,5260
"Lujan, Ben Ray",(D),Brender Law Firm,10200,0,10200
"Lujan, Ben Ray",(D),Pfizer Inc,10158,10000,158
"Lujan, Ben Ray",(D),Transport Workers Union,10050,10000,50
"Lujan, Ben Ray",(D),American Federation of State/Cnty/Munic Employees,10040,10000,40
"Lujan, Ben Ray",(D),American Medical Assn,10020,10000,20
"Lujan, Ben Ray",(D),A New Direction PAC,10000,10000,0
"Lujan, Ben Ray",(D),All for Our Country,10000,10000,0
"Lujan, Ben Ray",(D),America Works,10000,10000,0
"Lujan, Ben Ray",(D),America's Communication Assn,10000,10000,0
"Lujan, Ben Ray",(D),American Crystal Sugar,10000,10000,0
"Lujan, Ben Ray",(D),American Health Care Assn,10000,10000,0
"Lujan, Ben Ray",(D),American Physical Therapy Assn,10000,10000,0
"Lujan, Ben Ray",(D),AmeriPAC: The Fund for a Greater America,10000,10000,0
"Lujan, Ben Ray",(D),Common Ground PAC,10000,10000,0
"Lujan, Ben Ray",(D),Common Sense Colorado,10000,10000,0
"Lujan, Ben Ray",(D),Congressional Black Caucus PAC,10000,10000,0
"Lujan, Ben Ray",(D),Council of Insurance Agents & Brokers,10000,10000,0
"Lujan, Ben Ray",(D),Credit Union National Assn,10000,10000,0
"Lujan, Ben Ray",(D),Forward Together PAC,10000,10000,0
"Lummis, Cynthia",(R),Senate Conservatives Fund,146748,0,146748
"Lummis, Cynthia",(R),Club for Growth,139288,0,139288
"Lummis, Cynthia",(R),Multicoin Capital,35600,0,35600
"Lummis, Cynthia",(R),Sinclair Companies,28400,0,28400
"Lummis, Cynthia",(R),National Assn of Convenience Stores,25000,25000,0
"Lummis, Cynthia",(R),"National Stone, Sand & Gravel Assn",25000,25000,0
"Lummis, Cynthia",(R),Pinnacle West Capital,25000,25000,0
"Lummis, Cynthia",(R),Koch Industries,20000,20000,0
"Lummis, Cynthia",(R),Mortgage Bankers Assn,20000,20000,0
"Lummis, Cynthia",(R),National Assn of Realtors,20000,20000,0
"Lummis, Cynthia",(R),Rock Holdings,20000,20000,0
"Lummis, Cynthia",(R),Jackson Hole Mountain Resort,19900,0,19900
"Lummis, Cynthia",(R),Charter Communications,17500,17500,0
"Lummis, Cynthia",(R),PricewaterhouseCoopers,16500,16500,0
"Lummis, Cynthia",(R),United Parcel Service,16000,16000,0
"Lummis, Cynthia",(R),Paxos Trust Co,15800,0,15800
"Lummis, Cynthia",(R),UBS AG,15300,15000,300
"Lummis, Cynthia",(R),HollyFrontier Corp,15250,15000,250
"Lummis, Cynthia",(R),Bluegrass Cmte,15000,15000,0
"Lummis, Cynthia",(R),Common Values PAC,15000,15000,0
"Lummis, Cynthia",(R),Lead Encourage Elect PAC,15000,15000,0
"Lummis, Cynthia",(R),National Assn of Broadcasters,15000,15000,0
"Lummis, Cynthia",(R),National Beer Wholesalers Assn,15000,15000,0
"Lummis, Cynthia",(R),Value in Electing Women PAC,15000,15000,0
"Lummis, Cynthia",(R),Invariant LLC,12850,0,12850
"Lummis, Cynthia",(R),Altria Group,12750,12500,250
"Lummis, Cynthia",(R),Vaneck,12700,0,12700
"Lummis, Cynthia",(R),Berkshire Hathaway,12517,12500,17
"Lummis, Cynthia",(R),Chevron Corp,12500,12500,0
"Lummis, Cynthia",(R),Comcast Corp,12500,12500,0
"Lummis, Cynthia",(R),Exxon Mobil,12026,12000,26
"Lummis, Cynthia",(R),Payward Inc,11850,0,11850
"Lummis, Cynthia",(R),Andreessen Horowitz,11600,0,11600
"Lummis, Cynthia",(R),Peabody Energy,11500,11000,500
"Lummis, Cynthia",(R),San Francisco Giants,11200,0,11200
"Lummis, Cynthia",(R),Amgen Inc,11000,11000,0
"Lummis, Cynthia",(R),"Tarplin, Downs & Young",10600,0,10600
"Lummis, Cynthia",(R),Occidental Petroleum,10500,10000,500
"Lummis, Cynthia",(R),Southern Co,10060,10000,60
"Lummis, Cynthia",(R),Delta Air Lines,10035,10000,35
"Lummis, Cynthia",(R),"Akin, Gump et al",10000,0,10000
"Lummis, Cynthia",(R),Alamo PAC,10000,10000,0
"Lummis, Cynthia",(R),Badlands PAC,10000,10000,0
"Lummis, Cynthia",(R),Burns & McDonnell,10000,10000,0
"Lummis, Cynthia",(R),Citizens United,10000,10000,0
"Lummis, Cynthia",(R),Continuing America's Strength & Security,10000,10000,0
"Lummis, Cynthia",(R),Council of Insurance Agents & Brokers,10000,10000,0
"Lummis, Cynthia",(R),Credit Union National Assn,10000,10000,0
"Lummis, Cynthia",(R),Freedom Fund,10000,10000,0
"Lummis, Cynthia",(R),Fund for a Conservative Future,10000,10000,0
"Lummis, Cynthia",(R),Fund for America's Future,10000,10000,0
"Lummis, Cynthia",(R),Halliburton Co,10000,10000,0
"Lummis, Cynthia",(R),Heartland Values PAC,10000,10000,0
"Lummis, Cynthia",(R),Making Business Excel PAC,10000,10000,0
"Lummis, Cynthia",(R),MARSHA PAC,10000,10000,0
"Lummis, Cynthia",(R),National Auto Dealers Assn,10000,10000,0
"Lummis, Cynthia",(R),National Multifamily Housing Council,10000,10000,0
"Lummis, Cynthia",(R),Nebraska Sandhills PAC,10000,10000,0
"Lummis, Cynthia",(R),Norfolk Southern,10000,10000,0
"Lummis, Cynthia",(R),Project West PAC,10000,10000,0
"Lummis, Cynthia",(R),Reinventing a New Direction,10000,10000,0
"Lummis, Cynthia",(R),Rely on Your Beliefs,10000,10000,0
"Lummis, Cynthia",(R),Responsibility & Freedom Work PAC,10000,10000,0
"Lummis, Cynthia",(R),Together Holding Our Majority PAC,10000,10000,0
"Lummis, Cynthia",(R),Toyota Motor North America,10000,10000,0
"Lummis, Cynthia",(R),US Chamber of Commerce,10000,10000,0
"Lummis, Cynthia",(R),Woolpert Inc,10000,10000,0
"Lummis, Cynthia",(R),Holland & Hart,9550,5000,4550
"Lummis, Cynthia",(R),GSK plc,9500,9500,0
"Lummis, Cynthia",(R),Union Pacific Corp,9500,9500,0
"Lummis, Cynthia",(R),Fierce Government Relations,9100,0,9100
"Lummis, Cynthia",(R),AT&T Inc,9000,9000,0
"Lummis, Cynthia",(R),Regions Financial,9000,9000,0
"Lummis, Cynthia",(R),Wells Fargo,8500,7500,1000
"Lummis, Cynthia",(R),KDCR Partners,8050,0,8050
"Lummis, Cynthia",(R),American Trucking Assns,8000,7500,500
"Lummis, Cynthia",(R),Verizon Communications,8000,7500,500
"Lummis, Cynthia",(R),DISH Network,7850,5000,2850
"Lummis, Cynthia",(R),Croel Redi Mix,7700,0,7700
"Lummis, Cynthia",(R),Arch Resources,7500,7500,0
"Lummis, Cynthia",(R),Chesapeake Energy,7500,7500,0
"Lummis, Cynthia",(R),Genesis Alkali,7500,0,7500
"Lummis, Cynthia",(R),Hawkeye PAC,7500,7500,0
"Lummis, Cynthia",(R),Ovintiv USA,7500,7500,0
"Lummis, Cynthia",(R),Valero Energy,7500,7500,0
"Lummis, Cynthia",(R),Williams Companies,7500,7500,0
"Lummis, Cynthia",(R),American Institute of CPAs,7000,7000,0
"Lummis, Cynthia",(R),Lockheed Martin,7000,7000,0
"Lummis, Cynthia",(R),SP Capital Management,7000,0,7000
"Lummis, Cynthia",(R),Matcha Design Labs,6900,0,6900
"Lummis, Cynthia",(R),Microsoft Corp,6783,6000,783
"Lummis, Cynthia",(R),Capital Group Companies,6600,0,6600
"Lummis, Cynthia",(R),T-Mobile USA,6500,6500,0
"Lummis, Cynthia",(R),Association for Digital Asset Markets,6050,0,6050
"Lummis, Cynthia",(R),FedEx Corp,6005,6000,5
"Lummis, Cynthia",(R),Ernst & Young,6000,5000,1000
"Lummis, Cynthia",(R),National Assn of Health Underwriters,6000,6000,0
"Lummis, Cynthia",(R),ONEOK Inc,6000,5000,1000
"Lummis, Cynthia",(R),Van Eck Assoc,6000,0,6000
"Lummis, Cynthia",(R),1607 Strategies,5800,0,5800
"Manchin, Joe",(D),Capital Group Companies,184400,40000,144400
"Manchin, Joe",(D),West Virginia State Democratic Exec Cmte,100000,100000,0
"Manchin, Joe",(D),Viatris Inc,80425,0,80425
"Manchin, Joe",(D),Goldman Sachs,73100,17500,55600
"Manchin, Joe",(D),FirstEnergy Corp,61000,41000,20000
"Manchin, Joe",(D),Comcast Corp,55578,30000,25578
"Manchin, Joe",(D),Wexford Capital,45900,0,45900
"Manchin, Joe",(D),Steptoe & Johnson,43925,2500,41425
"Manchin, Joe",(D),NorPAC,41800,0,41800
"Manchin, Joe",(D),Altria Group,40500,40000,500
"Manchin, Joe",(D),Honeywell International,40025,40000,25
"Manchin, Joe",(D),National Rural Electric Cooperative Assn,40000,40000,0
"Manchin, Joe",(D),AT&T Inc,39926,35500,4426
"Manchin, Joe",(D),Berkshire Hathaway,37500,37500,0
"Manchin, Joe",(D),NCTA The Internet & Television Assn,37000,35000,2000
"Manchin, Joe",(D),Southern Co,36000,35000,1000
"Manchin, Joe",(D),Dominion Energy,35700,30000,5700
"Manchin, Joe",(D),American Bankers Assn,35000,35000,0
"Manchin, Joe",(D),CSX Corp,35000,35000,0
"Manchin, Joe",(D),International Brotherhood of Electrical Workers,35000,35000,0
"Manchin, Joe",(D),Lockheed Martin,34510,34500,10
"Manchin, Joe",(D),Norfolk Southern,34050,34000,50
"Manchin, Joe",(D),UnitedHealth Group,32501,32500,1
"Manchin, Joe",(D),Laborers Union,32500,32500,0
"Manchin, Joe",(D),"Wilson, Sonsini et al",32400,0,32400
"Manchin, Joe",(D),Northrop Grumman,31019,31000,19
"Manchin, Joe",(D),Independent Community Bankers of America,30500,30500,0
"Manchin, Joe",(D),KPMG LLP,30125,29500,625
"Manchin, Joe",(D),Loews Corp,29100,7500,21600
"Manchin, Joe",(D),General Motors,29002,29000,2
"Manchin, Joe",(D),General Atomics,28950,18500,10450
"Manchin, Joe",(D),Verizon Communications,28481,25000,3481
"Manchin, Joe",(D),National Multifamily Housing Council,27500,27500,0
"Manchin, Joe",(D),United Mine Workers of America,25500,25500,0
"Manchin, Joe",(D),National Assn of Realtors,25000,25000,0
"Manchin, Joe",(D),Operating Engineers Union,25000,25000,0
"Manchin, Joe",(D),Drummond Co,24900,5000,19900
"Manchin, Joe",(D),Mortgage Bankers Assn,24500,24500,0
"Manchin, Joe",(D),Charter Communications,24000,24000,0
"Manchin, Joe",(D),US Cellular,23700,21000,2700
"Manchin, Joe",(D),United Parcel Service,23509,23500,9
"Manchin, Joe",(D),Power Rogers LLP,23450,0,23450
"Manchin, Joe",(D),America's Credit Unions,23000,23000,0
"Manchin, Joe",(D),New York Life Insurance,22951,22500,451
"Manchin, Joe",(D),Walt Disney Co,22951,5000,17951
"Manchin, Joe",(D),Eastman Chemical,22500,22500,0
"Manchin, Joe",(D),iHeartMedia Inc,22500,22500,0
"Manchin, Joe",(D),National Beer Wholesalers Assn,22500,22500,0
"Manchin, Joe",(D),Union Pacific Corp,22500,22500,0
"Manchin, Joe",(D),Natural Products Assn,21982,21982,0
"Manchin, Joe",(D),Ares Management,21600,0,21600
"Manchin, Joe",(D),Toyota Motor Corp,21045,21000,45
"Manchin, Joe",(D),Duke Energy,21000,16000,5000
"Manchin, Joe",(D),International Franchise Assn,21000,21000,0
"Manchin, Joe",(D),National Assn of Broadcasters,21000,21000,0
"Manchin, Joe",(D),EQT Corp,20000,20000,0
"Manchin, Joe",(D),International Paper,20000,20000,0
"Manchin, Joe",(D),National Assn of Chemical Distributors,20000,20000,0
"Manchin, Joe",(D),Pinnacle West Capital,20000,20000,0
"Manchin, Joe",(D),Polaris Inc,20000,20000,0
"Manchin, Joe",(D),Centerview Partners,19900,0,19900
"Manchin, Joe",(D),PricewaterhouseCoopers,19700,17000,2700
"Manchin, Joe",(D),TC Energy,19500,19500,0
"Manchin, Joe",(D),"Paul, Weiss et al",19400,0,19400
"Manchin, Joe",(D),Fedex Corp,19251,18500,751
"Manchin, Joe",(D),"Brownstein, Hyatt et al",19200,7000,12200
"Manchin, Joe",(D),RTX Corp,19060,18000,1060
"Manchin, Joe",(D),Investment Co Institute,19000,19000,0
"Manchin, Joe",(D),Walmart Inc,18220,18000,220
"Manchin, Joe",(D),Apollo Global Management,17803,0,17803
"Manchin, Joe",(D),Microsoft Corp,17779,12000,5779
"Manchin, Joe",(D),Cox Enterprises,17750,14500,3250
"Manchin, Joe",(D),Greenberg Traurig LLP,17537,7500,10037
"Manchin, Joe",(D),Ernst & Young,17500,17500,0
"Manchin, Joe",(D),National Assn of Convenience Stores,17500,17500,0
"Manchin, Joe",(D),Parsons Corp,17500,17500,0
"Manchin, Joe",(D),JPMorgan Chase & Co,17209,16500,709
"Manchin, Joe",(D),N3,17200,0,17200
"Manchin, Joe",(D),Association of KFC Franchisees,17000,17000,0
"Manchin, Joe",(D),Mostyn Law Firm,16800,0,16800
"Manchin, Joe",(D),West Virginia Paving,16700,0,16700
"Manchin, Joe",(D),Duchossois Group,16600,0,16600
"Manchin, Joe",(D),Alphabet Inc,16263,10000,6263
"Manchin, Joe",(D),Artery Capital Group,16200,0,16200
"Manchin, Joe",(D),Coury Financial,16200,0,16200
"Manchin, Joe",(D),Alston & Bird,16000,12500,3500
"Manchin, Joe",(D),American Express,16000,16000,0
"Manchin, Joe",(D),DCI Group,16000,7000,9000
"Manchin, Joe",(D),Independent Insurance Agents & Brokers of America,16000,16000,0
"Manchin, Joe",(D),SMART Transportation Division,16000,16000,0
"Manchin, Joe",(D),Amazon.com,15776,10000,5776
"Manchin, Joe",(D),Morgan Stanley,15600,4000,11600
"Manchin, Joe",(D),Squire Patton Boggs,15510,10000,5510
"Manchin, Joe",(D),AFLAC Inc,15500,15500,0
"Manchin, Joe",(D),National Marine Manufacturers Assn,15500,15500,0
"Manchin, Joe",(D),Hamilton Insurance Agency,15400,0,15400
"Manchin, Joe",(D),Hogan Lovells,15400,4000,11400
"Manchin, Joe",(D),Monmouth University,15400,0,15400
"Manchin, Joe",(D),Sutherland Capital Management,15400,0,15400
"Manchin, Joe",(D),Aetna Inc,15350,15000,350
"Markey, Ed",(D),Democracy Engine,134133,0,134133
"Markey, Ed",(D),Harvard University,113265,0,113265
"Markey, Ed",(D),Granite Telecommunications,104053,0,104053
"Markey, Ed",(D),WilmerHale LLP,96361,0,96361
"Markey, Ed",(D),Alphabet Inc,66917,3000,63917
"Markey, Ed",(D),Apollo Global Management,64358,0,64358
"Markey, Ed",(D),Mass General Brigham,56490,0,56490
"Markey, Ed",(D),Commonwealth of Massachusetts,55302,0,55302
"Markey, Ed",(D),Rock Creek Group,51850,0,51850
"Markey, Ed",(D),Boston University,47622,0,47622
"Markey, Ed",(D),Blackstone Group,41435,0,41435
"Markey, Ed",(D),Massachusetts Institute of Technology,37103,0,37103
"Markey, Ed",(D),Bain Capital,35509,0,35509
"Markey, Ed",(D),"Mintz, Levin et al",35144,0,35144
"Markey, Ed",(D),Tufts University,33554,0,33554
"Markey, Ed",(D),Fresenius Medical Care,33128,20000,13128
"Markey, Ed",(D),Air Line Pilots Assn,32510,32500,10
"Markey, Ed",(D),Artery Capital Group,32200,0,32200
"Markey, Ed",(D),American Assn for Justice,32135,30000,2135
"Markey, Ed",(D),"Akin, Gump et al",32100,750,31350
"Markey, Ed",(D),"Kleiner, Perkins et al",31600,0,31600
"Markey, Ed",(D),DISH Network,31215,17000,14215
"Markey, Ed",(D),University of Massachusetts,29933,0,29933
"Markey, Ed",(D),DLA Piper,29855,10000,19855
"Markey, Ed",(D),Covington & Burling,29832,2000,27832
"Markey, Ed",(D),Walmart Inc,27867,10000,17867
"Markey, Ed",(D),Calvin Cafritz Enterprises,26900,0,26900
"Markey, Ed",(D),Feeley & Driscoll,26200,0,26200
"Markey, Ed",(D),Wonderful Co,26200,0,26200
"Markey, Ed",(D),Microsoft Corp,25785,5500,20285
"Markey, Ed",(D),Beacon Companies,25338,0,25338
"Markey, Ed",(D),"Robbins, Geller et al",25268,0,25268
"Markey, Ed",(D),Kabafusion,25000,0,25000
"Markey, Ed",(D),"Cotchett, Pitre & McCarthy",24450,0,24450
"Markey, Ed",(D),Joseph Group,24400,0,24400
"Markey, Ed",(D),Marshfield Assoc,23800,0,23800
"Markey, Ed",(D),Liberty Mutual,23664,10500,13164
"Markey, Ed",(D),Nixon Peabody LLP,23432,3600,19832
"Markey, Ed",(D),Benenson Productions,23400,0,23400
"Markey, Ed",(D),Beth Israel Lahey Health,23332,0,23332
"Markey, Ed",(D),Capital Group Companies,23120,0,23120
"Markey, Ed",(D),National Air Traffic Controllers Assn,23000,23000,0
"Markey, Ed",(D),Rasky Partners,22550,0,22550
"Markey, Ed",(D),Northwest Biotherapeutics,22500,0,22500
"Markey, Ed",(D),Wingate Companies,22391,0,22391
"Markey, Ed",(D),BLS Investments,21200,0,21200
"Markey, Ed",(D),Lone Pine Capital,21200,0,21200
"Markey, Ed",(D),Route One Investment,21200,0,21200
"Markey, Ed",(D),"Nelson, Mullins et al",21190,21000,190
"Markey, Ed",(D),Carnival Corp,20917,0,20917
"Markey, Ed",(D),Apple Inc,20595,0,20595
"Markey, Ed",(D),Verizon Communications,20265,7500,12765
"Markey, Ed",(D),International Brotherhood of Electrical Workers,20075,20000,75
"Markey, Ed",(D),Twitter,19003,2500,16503
"Markey, Ed",(D),Amazon.com,18963,1000,17963
"Markey, Ed",(D),National Assn of Broadcasters,18500,17500,1000
"Markey, Ed",(D),League of Conservation Voters,18470,18160,310
"Markey, Ed",(D),Power Rogers Llp,18200,0,18200
"Markey, Ed",(D),Amgen Inc,17938,17500,438
"Markey, Ed",(D),Dell Technologies,17800,15000,2800
"Markey, Ed",(D),iHeartMedia Inc,17716,10000,7716
"Markey, Ed",(D),America's Communication Assn,17500,17500,0
"Markey, Ed",(D),"Brownstein, Hyatt et al",17500,2000,15500
"Markey, Ed",(D),CSX Corp,17500,17500,0
"Markey, Ed",(D),International Assn of Fire Fighters,17500,17500,0
"Markey, Ed",(D),Union Pacific Corp,17500,17500,0
"Markey, Ed",(D),University of California,17473,0,17473
"Markey, Ed",(D),Service Employees International Union,17455,10000,7455
"Markey, Ed",(D),Biogen,17368,8500,8868
"Markey, Ed",(D),Meredith Management,17150,0,17150
"Markey, Ed",(D),Walt Disney Co,17018,2500,14518
"Markey, Ed",(D),Berkshire Group,17000,0,17000
"Markey, Ed",(D),Northwest Bio Therapeutics,16800,0,16800
"Markey, Ed",(D),IBM Corp,16793,0,16793
"Markey, Ed",(D),Writers Guild of America West,16725,15000,1725
"Markey, Ed",(D),Third Rock Ventures,16700,0,16700
"Markey, Ed",(D),Suffolk Construction,16548,0,16548
"Markey, Ed",(D),National Basketball Assn,16300,0,16300
"Markey, Ed",(D),Triumvirate Environmental,16200,0,16200
"Markey, Ed",(D),National Health Law Program,15660,0,15660
"Markey, Ed",(D),Shifamed LLC,15600,0,15600
"Markey, Ed",(D),T-Mobile USA,15364,15000,364
"Markey, Ed",(D),State Street Corp,15347,3000,12347
"Markey, Ed",(D),National Assn of Realtors,15065,15000,65
"Markey, Ed",(D),National Assn of Letter Carriers,15054,15000,54
"Markey, Ed",(D),Ocean Spray Cranberries,15000,15000,0
"Markey, Ed",(D),Slim-Fast Foods,15000,0,15000
"Markey, Ed",(D),Morgan Lewis LLP,14945,0,14945
"Markey, Ed",(D),Vertex Pharmaceuticals,14846,12000,2846
"Markey, Ed",(D),Cassidy & Assoc,14550,0,14550
"Markey, Ed",(D),Unity Technologies,14381,0,14381
"Markey, Ed",(D),Sanofi,14248,10000,4248
"Markey, Ed",(D),Lockheed Martin,14180,11000,3180
"Markey, Ed",(D),Wiley Rein Llp,14093,0,14093
"Markey, Ed",(D),Icm Partners,13850,0,13850
"Markey, Ed",(D),Common Ground PAC,13800,10000,3800
"Markey, Ed",(D),WPP plc,13706,0,13706
"Markey, Ed",(D),Immigrant Learning Center,13700,0,13700
"Markey, Ed",(D),"Preotle, Lane & Assoc",13600,0,13600
"Markey, Ed",(D),Thermo Fisher Scientific,13550,13000,550
"Marshall, Roger",(R),Poet LLC,47500,15000,32500
"Marshall, Roger",(R),National Republican Senatorial Cmte,44600,44600,0
"Marshall, Roger",(R),Nueterra Capital,43600,0,43600
"Marshall, Roger",(R),Watco Companies,26000,0,26000
"Marshall, Roger",(R),Koch Industries,25600,20000,5600
"Marshall, Roger",(R),Burns & McDonnell,22036,10000,12036
"Marshall, Roger",(R),Bukaty Companies,21100,0,21100
"Marshall, Roger",(R),Susan B Anthony List,20200,7800,12400
"Marshall, Roger",(R),American Crystal Sugar,20000,20000,0
"Marshall, Roger",(R),American Optometric Assn,20000,20000,0
"Marshall, Roger",(R),Growth Energy,20000,20000,0
"Marshall, Roger",(R),Goldman Sachs,19100,10000,9100
"Marshall, Roger",(R),National Air Traffic Controllers Assn,19000,19000,0
"Marshall, Roger",(R),American Bankers Assn,18525,17500,1025
"Marshall, Roger",(R),United Parcel Service,18070,18000,70
"Marshall, Roger",(R),Bristol-Myers Squibb,17600,10000,7600
"Marshall, Roger",(R),Innovative Livestock Services,16800,0,16800
"Marshall, Roger",(R),Cox Enterprises,16600,10000,6600
"Marshall, Roger",(R),American Society of Anesthesiologists,16500,16500,0
"Marshall, Roger",(R),Northrock Inc,16200,0,16200
"Marshall, Roger",(R),Rock Holdings,15600,10000,5600
"Marshall, Roger",(R),American Medical Assn,15100,15000,100
"Marshall, Roger",(R),American Assn of Orthopaedic Surgeons,15000,15000,0
"Marshall, Roger",(R),American College of Radiology,15000,15000,0
"Marshall, Roger",(R),HollyFrontier Corp,15000,15000,0
"Marshall, Roger",(R),Marathon Petroleum,15000,15000,0
"Marshall, Roger",(R),Blackstone Group,14900,0,14900
"Marshall, Roger",(R),Kansas City Southern,14820,7500,7320
"Marshall, Roger",(R),Alston & Bird,14500,12500,2000
"Marshall, Roger",(R),P&B Insurance Agency,14200,0,14200
"Marshall, Roger",(R),Berkshire Hathaway,13820,10000,3820
"Marshall, Roger",(R),Macerich Co,13224,0,13224
"Marshall, Roger",(R),McGuireWoods LLP,13000,13000,0
"Marshall, Roger",(R),Spirit Aerosystems,12575,10000,2575
"Marshall, Roger",(R),CRH Americas,12500,10000,2500
"Marshall, Roger",(R),Reeve Cattle Co,12200,0,12200
"Marshall, Roger",(R),Rothman Institute,12050,10000,2050
"Marshall, Roger",(R),American Chemistry Council,12000,12000,0
"Marshall, Roger",(R),Francis Financial Services,11950,0,11950
"Marshall, Roger",(R),Sporer Land Development,11850,0,11850
"Marshall, Roger",(R),Hallmark Cards,11664,5000,6664
"Marshall, Roger",(R),CVS Health,11580,0,11580
"Marshall, Roger",(R),Valuehealth,11400,0,11400
"Marshall, Roger",(R),Conestoga Energy Partners,11200,0,11200
"Marshall, Roger",(R),Creativeone,11200,0,11200
"Marshall, Roger",(R),Hodgdon Powder,11200,0,11200
"Marshall, Roger",(R),Jvc Investment Partners,11200,0,11200
"Marshall, Roger",(R),Magnolia Marketing,11200,0,11200
"Marshall, Roger",(R),American Academy of Dermatology Assn,11000,11000,0
"Marshall, Roger",(R),Ball Consulting Group,11000,0,11000
"Marshall, Roger",(R),Fry Eye Assoc,10900,0,10900
"Marshall, Roger",(R),Icm Inc,10900,0,10900
"Marshall, Roger",(R),Kumar Family Limited Partnership,10800,0,10800
"Marshall, Roger",(R),Jomax Construction,10750,0,10750
"Marshall, Roger",(R),Deloitte LLP,10600,10000,600
"Marshall, Roger",(R),Edward C Levy Co,10600,0,10600
"Marshall, Roger",(R),Foote Cattle Co,10600,0,10600
"Marshall, Roger",(R),Sierra Investments,10600,0,10600
"Marshall, Roger",(R),Altria Group,10530,10000,530
"Marshall, Roger",(R),PricewaterhouseCoopers,10525,10000,525
"Marshall, Roger",(R),Ernst & Young,10500,10000,500
"Marshall, Roger",(R),McKee Foods,10400,0,10400
"Marshall, Roger",(R),Wichita Urology Group,10300,0,10300
"Marshall, Roger",(R),Cerner Corp,10255,10000,255
"Marshall, Roger",(R),Polsinelli PC,10175,6000,4175
"Marshall, Roger",(R),FedEx Corp,10150,10000,150
"Marshall, Roger",(R),National Cattlemen's Beef Assn,10100,10000,100
"Marshall, Roger",(R),Exxon Mobil,10091,10000,91
"Marshall, Roger",(R),KPMG LLP,10010,10000,10
"Marshall, Roger",(R),AT&T Inc,10007,10000,7
"Marshall, Roger",(R),Air Line Pilots Assn,10000,10000,0
"Marshall, Roger",(R),Alabama Farmers Federation,10000,10000,0
"Marshall, Roger",(R),American Academy of Ophthalmology,10000,10000,0
"Marshall, Roger",(R),American Assn of Neurological Surgeons,10000,10000,0
"Marshall, Roger",(R),American College of Emergency Physicians,10000,10000,0
"Marshall, Roger",(R),American College of Surgeons Prof Assn,10000,10000,0
"Marshall, Roger",(R),American Physical Therapy Assn,10000,10000,0
"Marshall, Roger",(R),American Society of Plastic Surgeons,10000,10000,0
"Marshall, Roger",(R),Archer Daniels Midland,10000,10000,0
"Marshall, Roger",(R),Associated General Contractors,10000,10000,0
"Marshall, Roger",(R),Bluegrass Cmte,10000,10000,0
"Marshall, Roger",(R),BYRNE PAC,10000,10000,0
"Marshall, Roger",(R),Common Values PAC,10000,10000,0
"Marshall, Roger",(R),Council of Insurance Agents & Brokers,10000,10000,0
"Marshall, Roger",(R),Credit Union National Assn,10000,10000,0
"Marshall, Roger",(R),Dairy Farmers of America,10000,10000,0
"Marshall, Roger",(R),Deere & Co,10000,10000,0
"Marshall, Roger",(R),Farm Credit Council,10000,10000,0
"Marshall, Roger",(R),Farmers' Rice Cooperative,10000,10000,0
"Marshall, Roger",(R),Heartland Values PAC,10000,10000,0
"Marshall, Roger",(R),Independent Insurance Agents & Brokers of America,10000,10000,0
"Marshall, Roger",(R),International Franchise Assn,10000,10000,0
"Marshall, Roger",(R),Livestock Marketing Assn,10000,7500,2500
"Marshall, Roger",(R),Lockton Inc,10000,10000,0
"Marshall, Roger",(R),National Assn of Realtors,10000,10000,0
"Marshall, Roger",(R),National Assn of Spine Specialists,10000,10000,0
"Marshall, Roger",(R),National Assn of Wholesaler-Distributors,10000,10000,0
"Marshall, Roger",(R),National Auto Dealers Assn,10000,10000,0
"Marshall, Roger",(R),National Beer Wholesalers Assn,10000,10000,0
"Marshall, Roger",(R),National Community Pharmacists Assn,10000,10000,0
"Masto, Catherine Cortez",(D),EMILY's List,567983,10000,557983
"Masto, Catherine Cortez",(D),League of Conservation Voters,401480,8050,393430
"Masto, Catherine Cortez",(D),JStreetPAC,201558,999,200559
"Masto, Catherine Cortez",(D),University of California,97186,0,97186
"Masto, Catherine Cortez",(D),University of Nevada,73759,0,73759
"Masto, Catherine Cortez",(D),Silver Lake Partners,59188,15000,44188
"Masto, Catherine Cortez",(D),Democratic Senatorial Campaign Cmte,57400,46800,10600
"Masto, Catherine Cortez",(D),Honeywell International,55197,20000,35197
"Masto, Catherine Cortez",(D),Council for a Livable World,54733,1000,53733
"Masto, Catherine Cortez",(D),Comcast Corp,52990,20000,32990
"Masto, Catherine Cortez",(D),MGM Resorts International,47221,20000,27221
"Masto, Catherine Cortez",(D),Alphabet Inc,46196,20000,26196
"Masto, Catherine Cortez",(D),Berkshire Hathaway,43229,37500,5729
"Masto, Catherine Cortez",(D),Microsoft Corp,42083,23500,18583
"Masto, Catherine Cortez",(D),Women's Cancer Center of Nevada,36900,0,36900
"Masto, Catherine Cortez",(D),Sorensen's Resort,36175,0,36175
"Masto, Catherine Cortez",(D),"Akin, Gump et al",34438,1000,33438
"Masto, Catherine Cortez",(D),Munoz & Co,32700,0,32700
"Masto, Catherine Cortez",(D),National Air Traffic Controllers Assn,32500,32500,0
"Masto, Catherine Cortez",(D),"Brownstein, Hyatt et al",32350,1000,31350
"Masto, Catherine Cortez",(D),"Sheet Metal, Air, Rail & Transportation Union",32000,30000,2000
"Masto, Catherine Cortez",(D),Boyd Gaming,31515,15000,16515
"Masto, Catherine Cortez",(D),Stanford University,30669,0,30669
"Masto, Catherine Cortez",(D),Ulta Beauty,30400,0,30400
"Masto, Catherine Cortez",(D),International Brotherhood of Electrical Workers,30376,30000,376
"Masto, Catherine Cortez",(D),Susman Godfrey LLP,29350,0,29350
"Masto, Catherine Cortez",(D),Meruelo Group,28900,0,28900
"Masto, Catherine Cortez",(D),Pfizer Inc,28536,25000,3536
"Masto, Catherine Cortez",(D),Bend The Arc Jewish Action,28185,10000,18185
"Masto, Catherine Cortez",(D),Motley Rice LLC,27540,0,27540
"Masto, Catherine Cortez",(D),"Enenstein, Ribakoff et al",27213,0,27213
"Masto, Catherine Cortez",(D),City University of New York,27025,0,27025
"Masto, Catherine Cortez",(D),Kynikos Assoc,27000,0,27000
"Masto, Catherine Cortez",(D),Thompson & Knight,26800,0,26800
"Masto, Catherine Cortez",(D),Harvard University,26724,0,26724
"Masto, Catherine Cortez",(D),Barona Band of Mission Indians,26500,0,26500
"Masto, Catherine Cortez",(D),National Beer Wholesalers Assn,26500,26500,0
"Masto, Catherine Cortez",(D),Kansas City Urology Care,26000,0,26000
"Masto, Catherine Cortez",(D),NCTA The Internet & Television Assn,26000,15000,11000
"Masto, Catherine Cortez",(D),Deloitte LLP,25281,20000,5281
"Masto, Catherine Cortez",(D),UNITE HERE,25124,25000,124
"Masto, Catherine Cortez",(D),Air Line Pilots Assn,25050,25000,50
"Masto, Catherine Cortez",(D),Border Health,25000,25000,0
"Masto, Catherine Cortez",(D),Carpenters & Joiners Union,25000,25000,0
"Masto, Catherine Cortez",(D),UnitedHealth Group,24870,17500,7370
"Masto, Catherine Cortez",(D),Senior Care Pharmacy Coalition,24250,10000,14250
"Masto, Catherine Cortez",(D),National Education Assn,24149,20000,4149
"Masto, Catherine Cortez",(D),Van Wagner Communications,23950,0,23950
"Masto, Catherine Cortez",(D),AT&T Inc,23949,7000,16949
"Masto, Catherine Cortez",(D),State of California,23800,0,23800
"Masto, Catherine Cortez",(D),Thornton Law Firm,23300,0,23300
"Masto, Catherine Cortez",(D),Weitz & Luxenberg,22940,0,22940
"Masto, Catherine Cortez",(D),American Assn for Justice,22925,22500,425
"Masto, Catherine Cortez",(D),Vail Resorts,22918,17500,5418
"Masto, Catherine Cortez",(D),PricewaterhouseCoopers,22894,15000,7894
"Masto, Catherine Cortez",(D),Humana Inc,22626,22500,126
"Masto, Catherine Cortez",(D),A&B Printing & Mailing,22500,0,22500
"Masto, Catherine Cortez",(D),National Assn of Real Estate Investment Trusts,22500,22500,0
"Masto, Catherine Cortez",(D),Womencount PAC,22048,260,21788
"Masto, Catherine Cortez",(D),Southern Glazer's Wine & Spirits,21863,5000,16863
"Masto, Catherine Cortez",(D),Apercen Partners,21600,0,21600
"Masto, Catherine Cortez",(D),Greenberg Traurig LLP,21305,0,21305
"Masto, Catherine Cortez",(D),Voices for Progress,21234,334,20900
"Masto, Catherine Cortez",(D),America's Credit Unions,21000,21000,0
"Masto, Catherine Cortez",(D),American Health Care Assn,21000,18500,2500
"Masto, Catherine Cortez",(D),Blackstone Group,20901,0,20901
"Masto, Catherine Cortez",(D),Dickinson Wright Pllc,20775,0,20775
"Masto, Catherine Cortez",(D),Operating Engineers Union,20764,20000,764
"Masto, Catherine Cortez",(D),"Wright, Stanish & Winckler",20700,0,20700
"Masto, Catherine Cortez",(D),"Clark County, NV",20441,0,20441
"Masto, Catherine Cortez",(D),JAMS Inc,20433,0,20433
"Masto, Catherine Cortez",(D),New York University,20419,0,20419
"Masto, Catherine Cortez",(D),Altria Group,20125,12500,7625
"Masto, Catherine Cortez",(D),Charter Communications,20077,20000,77
"Masto, Catherine Cortez",(D),American Hotel & Lodging Assn,20000,20000,0
"Masto, Catherine Cortez",(D),American Society of Anesthesiologists,20000,20000,0
"Masto, Catherine Cortez",(D),Great Lakes PAC,20000,20000,0
"Masto, Catherine Cortez",(D),Peirson & Patterson,20000,0,20000
"Masto, Catherine Cortez",(D),Transport Workers Union,20000,20000,0
"Masto, Catherine Cortez",(D),University of Michigan,19991,0,19991
"Masto, Catherine Cortez",(D),Blue Cross/Blue Shield,19946,13000,6946
"Masto, Catherine Cortez",(D),Goldman Sachs,19753,6000,13753
"Masto, Catherine Cortez",(D),Greenspun Corp,19261,0,19261
"Masto, Catherine Cortez",(D),Cooney & Conway,19200,0,19200
"Masto, Catherine Cortez",(D),Amgen Inc,19109,20000,-891
"Masto, Catherine Cortez",(D),Arcata Assoc,19000,0,19000
"Masto, Catherine Cortez",(D),National Multifamily Housing Council,18950,18500,450
"Masto, Catherine Cortez",(D),Starwood Capital Group,18904,0,18904
"Masto, Catherine Cortez",(D),Weltz & Luxenberg PC,18900,0,18900
"Masto, Catherine Cortez",(D),Clifford Law Offices,18700,0,18700
"Masto, Catherine Cortez",(D),T-Mobile USA,18586,18500,86
"Masto, Catherine Cortez",(D),Caesars Entertainment,18497,11000,7497
"Masto, Catherine Cortez",(D),University of Pennsylvania,18370,0,18370
"Masto, Catherine Cortez",(D),Allegiant Travel Co,18276,10000,8276
"Masto, Catherine Cortez",(D),US Government,18226,0,18226
"Masto, Catherine Cortez",(D),Cigna Corp,18084,17500,584
"Masto, Catherine Cortez",(D),Northrop Grumman,17939,15000,2939
"Masto, Catherine Cortez",(D),Cox Enterprises,17558,17500,58
"Masto, Catherine Cortez",(D),United Food & Commercial Workers Union,17524,17500,24
"Masto, Catherine Cortez",(D),Ironworkers Union,17500,17500,0
"McConnell, Mitch",(R),NorPAC,163575,0,163575
"McConnell, Mitch",(R),Altria Group,142635,35000,107635
"McConnell, Mitch",(R),United Parcel Service,142600,40000,102600
"McConnell, Mitch",(R),Capital Group Companies,128143,23500,104643
"McConnell, Mitch",(R),Votesane PAC,127400,100,127300
"McConnell, Mitch",(R),Blackstone Group,124542,1000,123542
"McConnell, Mitch",(R),Eli Lilly & Co,114039,33500,80539
"McConnell, Mitch",(R),LHC Group,111877,20000,91877
"McConnell, Mitch",(R),AT&T Inc,102295,45000,57295
"McConnell, Mitch",(R),Blue Cross/Blue Shield,97935,75000,22935
"McConnell, Mitch",(R),NextEra Energy,97091,30000,67091
"McConnell, Mitch",(R),KKR & Co,96478,12500,83978
"McConnell, Mitch",(R),FedEx Corp,96164,40000,56164
"McConnell, Mitch",(R),Humana Inc,90151,40000,50151
"McConnell, Mitch",(R),Kindred Healthcare,88097,22500,65597
"McConnell, Mitch",(R),Metlife Inc,85838,40000,45838
"McConnell, Mitch",(R),Comcast Corp,85000,40000,45000
"McConnell, Mitch",(R),DaVita Inc,83144,35000,48144
"McConnell, Mitch",(R),American Airlines Group,79117,30000,49117
"McConnell, Mitch",(R),BGR Group,78589,10250,68339
"McConnell, Mitch",(R),Pfizer Inc,77076,28499,48577
"McConnell, Mitch",(R),UnitedHealth Group,72035,25000,47035
"McConnell, Mitch",(R),Amgen Inc,71606,35000,36606
"McConnell, Mitch",(R),Charter Communications,68980,20000,48980
"McConnell, Mitch",(R),Cigna Corp,68407,40000,28407
"McConnell, Mitch",(R),Berkshire Hathaway,66231,31000,35231
"McConnell, Mitch",(R),Bristol-Myers Squibb,65239,42500,22739
"McConnell, Mitch",(R),Brown-Forman Corp,64170,25000,39170
"McConnell, Mitch",(R),Apollo Global Management,63846,10000,53846
"McConnell, Mitch",(R),JPMorgan Chase & Co,63727,20000,43727
"McConnell, Mitch",(R),AbbVie Inc,63314,52500,10814
"McConnell, Mitch",(R),GEO Group,62204,15000,47204
"McConnell, Mitch",(R),Goldman Sachs,61079,20000,41079
"McConnell, Mitch",(R),CVS Health,59072,50000,9072
"McConnell, Mitch",(R),Fidelity Investments,58750,29000,29750
"McConnell, Mitch",(R),"Brownstein, Hyatt et al",58650,7000,51650
"McConnell, Mitch",(R),Select Medical Corp,57628,12500,45128
"McConnell, Mitch",(R),Raytheon Technologies,57616,33500,24116
"McConnell, Mitch",(R),Walmart Inc,57151,35000,22151
"McConnell, Mitch",(R),CSX Corp,56484,45000,11484
"McConnell, Mitch",(R),Honeywell International,56226,40000,16226
"McConnell, Mitch",(R),Verizon Communications,55596,40000,15596
"McConnell, Mitch",(R),Southern Co,54129,40000,14129
"McConnell, Mitch",(R),CC Clark Inc,53388,0,53388
"McConnell, Mitch",(R),Ford Motor Co,53028,40000,13028
"McConnell, Mitch",(R),Leon Medical Centers,53000,0,53000
"McConnell, Mitch",(R),Walt Disney Co,50819,15000,35819
"McConnell, Mitch",(R),Delta Air Lines,50223,36000,14223
"McConnell, Mitch",(R),Northrop Grumman,49777,32500,17277
"McConnell, Mitch",(R),America's Credit Unions,49500,48500,1000
"McConnell, Mitch",(R),Merck & Co,47648,40000,7648
"McConnell, Mitch",(R),Deloitte LLP,46801,40000,6801
"McConnell, Mitch",(R),BP,45785,22500,23285
"McConnell, Mitch",(R),General Motors,45410,37500,7910
"McConnell, Mitch",(R),Alphabet Inc,45342,40000,5342
"McConnell, Mitch",(R),Microsoft Corp,45297,35000,10297
"McConnell, Mitch",(R),Associated General Contractors,45000,45000,0
"McConnell, Mitch",(R),Foley & Lardner,44320,9000,35320
"McConnell, Mitch",(R),Wiley Rein LLP,43620,0,43620
"McConnell, Mitch",(R),Abbott Laboratories,43358,40000,3358
"McConnell, Mitch",(R),National Assn of Realtors,42654,39999,2655
"McConnell, Mitch",(R),American Dental Assn,42600,40000,2600
"McConnell, Mitch",(R),Frost Brown Todd LLC,41505,0,41505
"McConnell, Mitch",(R),Home Depot,41413,30000,11413
"McConnell, Mitch",(R),American Council Of Life Insurers,41400,33000,8400
"McConnell, Mitch",(R),Bank of America,40925,2500,38425
"McConnell, Mitch",(R),Boeing Co,40516,22500,18016
"McConnell, Mitch",(R),Prudential Financial,40405,40000,405
"McConnell, Mitch",(R),National Assn of Home Builders,40008,40000,8
"McConnell, Mitch",(R),American Hotel & Lodging Assn,40000,40000,0
"McConnell, Mitch",(R),Automotive Free International Trade PAC,40000,40000,0
"McConnell, Mitch",(R),Mortgage Bankers Assn,40000,40000,0
"McConnell, Mitch",(R),National Auto Dealers Assn,40000,40000,0
"McConnell, Mitch",(R),National Beer Wholesalers Assn,40000,40000,0
"McConnell, Mitch",(R),National Rural Electric Cooperative Assn,40000,40000,0
"McConnell, Mitch",(R),NCTA The Internet & Television Assn,40000,40000,0
"McConnell, Mitch",(R),Massachusetts Mutual Life Insurance,39975,30000,9975
"McConnell, Mitch",(R),Union Pacific Corp,39643,37500,2143
"McConnell, Mitch",(R),International Paper,39440,39000,440
"McConnell, Mitch",(R),"Welsh, Carson et al",39400,0,39400
"McConnell, Mitch",(R),USAA,38082,35000,3082
"McConnell, Mitch",(R),American Institute of CPAs,38000,38000,0
"McConnell, Mitch",(R),Atlas Air Worldwide,37690,12500,25190
"McConnell, Mitch",(R),Caterpillar Inc,37597,25000,12597
"McConnell, Mitch",(R),Alkermes Inc,37525,10000,27525
"McConnell, Mitch",(R),National Multifamily Housing Council,37500,40000,-2500
"McConnell, Mitch",(R),Marathon Petroleum,37271,35000,2271
"McConnell, Mitch",(R),American Hospital Assn,37200,30000,7200
"McConnell, Mitch",(R),Miller Strategies,36950,0,36950
"McConnell, Mitch",(R),Beam Suntory,36793,0,36793
"McConnell, Mitch",(R),AFLAC Inc,36207,35000,1207
"McConnell, Mitch",(R),Corning Inc,36070,28500,7570
"McConnell, Mitch",(R),Wells Fargo,35616,15000,20616
"McConnell, Mitch",(R),Woodbranch Investments,35600,0,35600
"McConnell, Mitch",(R),AstraZeneca PLC,35206,32500,2706
"McConnell, Mitch",(R),Anheuser-Busch InBev,35099,35000,99
"McConnell, Mitch",(R),Eastman Chemical,35073,30000,5073
"McConnell, Mitch",(R),California Dairies Inc,35000,35000,0
"McConnell, Mitch",(R),National Assn of Convenience Stores,35000,35000,0
"McConnell, Mitch",(R),National Assn of Real Estate Investment Trusts,35000,35000,0
"Menendez, Robert",(D),NorPAC,266389,15500,250889
"Menendez, Robert",(D),Inserra Supermarkets,93600,0,93600
"Menendez, Robert",(D),Lowenstein Sandler LLP,81415,0,81415
"Menendez, Robert",(D),Panepinto Properties,67700,0,67700
"Menendez, Robert",(D),"Carella, Byrne et al",60818,0,60818
"Menendez, Robert",(D),Goldman Sachs,56185,15000,41185
"Menendez, Robert",(D),AT&T Inc,53136,49000,4136
"Menendez, Robert",(D),Prudential Financial,53125,40000,13125
"Menendez, Robert",(D),Comcast Corp,52230,35000,17230
"Menendez, Robert",(D),Leon Medical Centers,52000,0,52000
"Menendez, Robert",(D),"Paul, Weiss et al",50750,0,50750
"Menendez, Robert",(D),Novartis AG,50138,23000,27138
"Menendez, Robert",(D),Daybreak Express,48365,0,48365
"Menendez, Robert",(D),Greenberg Traurig LLP,48305,7000,41305
"Menendez, Robert",(D),Gibbons PC,47350,7400,39950
"Menendez, Robert",(D),Federated Investors Inc,46000,5000,41000
"Menendez, Robert",(D),Blue Cross/Blue Shield,45505,30000,15505
"Menendez, Robert",(D),General Atomics,43800,18500,25300
"Menendez, Robert",(D),Public Service Enterprise Group,40248,17143,23105
"Menendez, Robert",(D),Motley Rice LLC,40000,0,40000
"Menendez, Robert",(D),National Assn of Real Estate Investment Trusts,40000,40000,0
"Menendez, Robert",(D),Bristol-Myers Squibb,39305,32500,6805
"Menendez, Robert",(D),National Assn of Home Builders,39300,39000,300
"Menendez, Robert",(D),National Assn of Realtors,39000,39000,0
"Menendez, Robert",(D),Mack-Cali Realty,38200,0,38200
"Menendez, Robert",(D),WPP plc,37021,2000,35021
"Menendez, Robert",(D),"Brownstein, Hyatt et al",36750,15500,21250
"Menendez, Robert",(D),Mortgage Bankers Assn,36500,36500,0
"Menendez, Robert",(D),Merck & Co,36255,35000,1255
"Menendez, Robert",(D),Amgen Inc,36000,34000,2000
"Menendez, Robert",(D),DLA Piper,35700,18000,17700
"Menendez, Robert",(D),"Pachulski, Stang et al",35100,0,35100
"Menendez, Robert",(D),IDT Corp,34900,10000,24900
"Menendez, Robert",(D),National Air Traffic Controllers Assn,32500,32500,0
"Menendez, Robert",(D),International Brotherhood of Electrical Workers,32000,32000,0
"Menendez, Robert",(D),"Akin, Gump et al",31900,6000,25900
"Menendez, Robert",(D),Microsoft Corp,29838,13500,16338
"Menendez, Robert",(D),Covanta Energy Corp,29500,21000,8500
"Menendez, Robert",(D),National Venture Capital Assn,29500,27500,2000
"Menendez, Robert",(D),Eli Lilly & Co,29110,16000,13110
"Menendez, Robert",(D),Freedom Capital Partners,29000,0,29000
"Menendez, Robert",(D),Miami International Holdings,28700,0,28700
"Menendez, Robert",(D),Pfizer Inc,28560,27500,1060
"Menendez, Robert",(D),Capitol Counsel,28250,0,28250
"Menendez, Robert",(D),Morgan Stanley,27400,15000,12400
"Menendez, Robert",(D),Lockheed Martin,27315,27000,315
"Menendez, Robert",(D),Tonio Burgos & Assoc,27300,0,27300
"Menendez, Robert",(D),Honeywell International,26785,25000,1785
"Menendez, Robert",(D),Monmouth Real Estate Investment,26750,0,26750
"Menendez, Robert",(D),HBJ Investments,26599,0,26599
"Menendez, Robert",(D),Chartwell Hotels,26400,0,26400
"Menendez, Robert",(D),"Sills, Cummis & Gross",26350,0,26350
"Menendez, Robert",(D),Blackstone Group,25500,5000,20500
"Menendez, Robert",(D),Morris Realty Lp,25400,0,25400
"Menendez, Robert",(D),American Assn for Justice,25000,25000,0
"Menendez, Robert",(D),Select Medical Corp,25000,20000,5000
"Menendez, Robert",(D),Waters McPherson Mcneill,24800,0,24800
"Menendez, Robert",(D),Daibes Enterprises,24159,0,24159
"Menendez, Robert",(D),Genesis 10,24100,0,24100
"Menendez, Robert",(D),General Motors,24000,22000,2000
"Menendez, Robert",(D),"Hudson County, NJ",23732,0,23732
"Menendez, Robert",(D),Johnson & Johnson,23589,22500,1089
"Menendez, Robert",(D),Kasowitz Benson Torres Llp,23415,0,23415
"Menendez, Robert",(D),Rasky Partners,23149,0,23149
"Menendez, Robert",(D),Krivit & Krivit,23065,0,23065
"Menendez, Robert",(D),Apollo Global Management,22700,0,22700
"Menendez, Robert",(D),Verizon Communications,22577,16000,6577
"Menendez, Robert",(D),Real Estate Roundtable,22500,22500,0
"Menendez, Robert",(D),Holy Name Medical Center,22090,0,22090
"Menendez, Robert",(D),National Multifamily Housing Council,22000,20000,2000
"Menendez, Robert",(D),Holland & Knight,21850,14500,7350
"Menendez, Robert",(D),Fairview Insurance Agency,21600,0,21600
"Menendez, Robert",(D),Rudin Management,21600,0,21600
"Menendez, Robert",(D),Air Line Pilots Assn,21500,21500,0
"Menendez, Robert",(D),Horizon Blue Cross,21500,0,21500
"Menendez, Robert",(D),Minno & Wasko Architects,21300,0,21300
"Menendez, Robert",(D),Citigroup Inc,21230,17500,3730
"Menendez, Robert",(D),LA Sunset Tanning Salon,20600,0,20600
"Menendez, Robert",(D),Rwjbarnabas Health,20253,0,20253
"Menendez, Robert",(D),Sanofi,20145,20000,145
"Menendez, Robert",(D),Arbor Realty Trust,20100,0,20100
"Menendez, Robert",(D),Laborers Union,20100,15000,5100
"Menendez, Robert",(D),Omnicom Group,20100,0,20100
"Menendez, Robert",(D),Carpenters & Joiners Union,20000,20000,0
"Menendez, Robert",(D),Ironworkers Union,20000,20000,0
"Menendez, Robert",(D),Fabuwood Cabinetry,19900,0,19900
"Menendez, Robert",(D),Manatos & Manatos,19805,0,19805
"Menendez, Robert",(D),Tom James Co,19700,2000,17700
"Menendez, Robert",(D),Holtec International,19600,0,19600
"Menendez, Robert",(D),Hovnanian Enterprises,19410,0,19410
"Menendez, Robert",(D),VantageKnight Inc,19400,0,19400
"Menendez, Robert",(D),Tiber Creek Group,19250,0,19250
"Menendez, Robert",(D),Hackensack University Medical Center,19038,0,19038
"Menendez, Robert",(D),Capital Group Companies,18900,0,18900
"Menendez, Robert",(D),Winning Strategies Washington,18678,3500,15178
"Menendez, Robert",(D),Genentech Inc,18559,18500,59
"Menendez, Robert",(D),Continental Food & Beverage,18500,0,18500
"Menendez, Robert",(D),Questor Management,18300,0,18300
"Menendez, Robert",(D),Novo Nordisk,17525,17500,25
"Menendez, Robert",(D),International Longshoremens Assn,17500,12500,5000
"Merkley, Jeff",(D),Oregon Health & Science University,77005,0,77005
"Merkley, Jeff",(D),State of Oregon,69286,0,69286
"Merkley, Jeff",(D),Intel Corp,66819,17500,49319
"Merkley, Jeff",(D),League of Conservation Voters,64347,15095,49252
"Merkley, Jeff",(D),Digital Vision Inc,62300,0,62300
"Merkley, Jeff",(D),Communications Workers of America,40649,40000,649
"Merkley, Jeff",(D),Matthews International Capital Management,39200,0,39200
"Merkley, Jeff",(D),International Brotherhood of Electrical Workers,37419,35000,2419
"Merkley, Jeff",(D),Kaiser Permanente,36902,0,36902
"Merkley, Jeff",(D),Tunica-Biloxi Tribe of Louisiana,35600,0,35600
"Merkley, Jeff",(D),University of Oregon,35411,0,35411
"Merkley, Jeff",(D),Oregon State University,33912,0,33912
"Merkley, Jeff",(D),Wihtol Law Office,32500,0,32500
"Merkley, Jeff",(D),Blue Basin Beef,31200,0,31200
"Merkley, Jeff",(D),National University of Singapore,31008,0,31008
"Merkley, Jeff",(D),National Assn of Realtors,30095,30000,95
"Merkley, Jeff",(D),"Kleiner, Perkins et al",29300,0,29300
"Merkley, Jeff",(D),Berkshire Hathaway,28030,7000,21030
"Merkley, Jeff",(D),National Air Traffic Controllers Assn,28000,28000,0
"Merkley, Jeff",(D),Vernier Software & Technology,27501,0,27501
"Merkley, Jeff",(D),JStreetPAC,27177,0,27177
"Merkley, Jeff",(D),Portland State University,25837,0,25837
"Merkley, Jeff",(D),National Assn of Letter Carriers,25174,25000,174
"Merkley, Jeff",(D),United Food & Commercial Workers Union,25000,25000,0
"Merkley, Jeff",(D),Thrivent Financial,24834,20000,4834
"Merkley, Jeff",(D),Teaching Strategies Inc,24058,0,24058
"Merkley, Jeff",(D),University of California,22187,0,22187
"Merkley, Jeff",(D),Service Employees International Union,21178,10000,11178
"Merkley, Jeff",(D),UNITE HERE,20453,20000,453
"Merkley, Jeff",(D),Greenbrier Companies,20015,0,20015
"Merkley, Jeff",(D),American Academy of Ophthalmology,20000,20000,0
"Merkley, Jeff",(D),Bricklayers Union,20000,15000,5000
"Merkley, Jeff",(D),National Community Action Foundation,20000,20000,0
"Merkley, Jeff",(D),American Federation of State/Cnty/Munic Employees,18814,17500,1314
"Merkley, Jeff",(D),"Stoll, Berne et al",18670,0,18670
"Merkley, Jeff",(D),Providence Health & Services,18301,0,18301
"Merkley, Jeff",(D),The Baffler,17600,0,17600
"Merkley, Jeff",(D),Capitol Counsel,17500,0,17500
"Merkley, Jeff",(D),Zumiez Inc,17396,0,17396
"Merkley, Jeff",(D),Lane Powell PC,16800,0,16800
"Merkley, Jeff",(D),"Sheet Metal, Air, Rail & Transportation Union",16500,16500,0
"Merkley, Jeff",(D),Cow Creek Band of Umpqua Indians,15600,0,15600
"Merkley, Jeff",(D),Panzi Foundation,15600,0,15600
"Merkley, Jeff",(D),Honeywell International,15360,15000,360
"Merkley, Jeff",(D),Comcast Corp,15275,2500,12775
"Merkley, Jeff",(D),Teamsters Union,15065,15000,65
"Merkley, Jeff",(D),American Assn for Justice,15000,15000,0
"Merkley, Jeff",(D),American Assn of Nurse Anesthesiology,15000,15000,0
"Merkley, Jeff",(D),Burns & McDonnell,15000,15000,0
"Merkley, Jeff",(D),International Assn of Fire Fighters,15000,15000,0
"Merkley, Jeff",(D),National Popular Vote,15000,0,15000
"Merkley, Jeff",(D),Transport Workers Union,15000,15000,0
"Merkley, Jeff",(D),Microsoft Corp,14205,5500,8705
"Merkley, Jeff",(D),Russell Fellows Properties,13821,0,13821
"Merkley, Jeff",(D),Corson & Johnson Law Firm,13799,0,13799
"Merkley, Jeff",(D),Managed Care Rn,13500,0,13500
"Merkley, Jeff",(D),National Multifamily Housing Council,13500,13500,0
"Merkley, Jeff",(D),Alphabet Inc,13472,6000,7472
"Merkley, Jeff",(D),Westly Group,13100,0,13100
"Merkley, Jeff",(D),Carlyle Group,13075,7500,5575
"Merkley, Jeff",(D),"Smith, Dawson & Andrews",13000,0,13000
"Merkley, Jeff",(D),Roseburg Forest Products,12815,0,12815
"Merkley, Jeff",(D),American Nurses Assn,12760,9000,3760
"Merkley, Jeff",(D),"Dr Curtis T Thompson & Assoc, L",12500,0,12500
"Merkley, Jeff",(D),Michael Curry Designs,12500,0,12500
"Merkley, Jeff",(D),American Postal Workers Union,12033,12000,33
"Merkley, Jeff",(D),Bauman Foundation,12000,0,12000
"Merkley, Jeff",(D),Portland Public Schools,11931,0,11931
"Merkley, Jeff",(D),Reed College,11881,0,11881
"Merkley, Jeff",(D),National Education Assn,11850,10000,1850
"Merkley, Jeff",(D),Annie Bloom's Books,11750,0,11750
"Merkley, Jeff",(D),HP Inc,11641,0,11641
"Merkley, Jeff",(D),Mountain Rose Herbs,11550,0,11550
"Merkley, Jeff",(D),Perkins Coie,11383,0,11383
"Merkley, Jeff",(D),Portland Community College,11359,0,11359
"Merkley, Jeff",(D),Davis Wright Tremaine LLP,11326,0,11326
"Merkley, Jeff",(D),Bad Robot Productions,11200,0,11200
"Merkley, Jeff",(D),"Draper, Fisher & Jurvetson",11200,0,11200
"Merkley, Jeff",(D),Klein Financial,11200,0,11200
"Merkley, Jeff",(D),Moga Investments,11200,0,11200
"Merkley, Jeff",(D),United Group,11200,0,11200
"Merkley, Jeff",(D),"Akin, Gump et al",11100,0,11100
"Merkley, Jeff",(D),McGinn & Co,11000,0,11000
"Merkley, Jeff",(D),Nike Inc,10963,2500,8463
"Merkley, Jeff",(D),Eye Health Northwest,10835,0,10835
"Merkley, Jeff",(D),Jubitz Family Foundation,10655,0,10655
"Merkley, Jeff",(D),Scanlankemperbard Companies,10642,0,10642
"Merkley, Jeff",(D),Fritts Group,10500,0,10500
"Merkley, Jeff",(D),"Williams, Love et al",10275,0,10275
"Merkley, Jeff",(D),General Motors,10120,10000,120
"Merkley, Jeff",(D),US Postal Service,10080,0,10080
"Merkley, Jeff",(D),Carpenters & Joiners Union,10055,10000,55
"Merkley, Jeff",(D),American Federation of Teachers,10050,10000,50
"Merkley, Jeff",(D),Invision App,10030,0,10030
"Merkley, Jeff",(D),America Works,10000,10000,0
"Merkley, Jeff",(D),American Assn of Nurse Anesthetists,10000,10000,0
"Merkley, Jeff",(D),American Veterinary Medical Assn,10000,10000,0
"Merkley, Jeff",(D),Common Ground PAC,10000,10000,0
"Merkley, Jeff",(D),Confederated Tribes of Grand Ronde,10000,0,10000
"Merkley, Jeff",(D),Digital Innovations Group,10000,0,10000
"Moran, Jerry",(R),Ciciora Custom Homes,154900,0,154900
"Moran, Jerry",(R),Union Pacific Corp,68275,40000,28275
"Moran, Jerry",(R),Bartlett Grain,64100,0,64100
"Moran, Jerry",(R),Spirit Aerosystems,63050,45000,18050
"Moran, Jerry",(R),Berkshire Hathaway,61300,40000,21300
"Moran, Jerry",(R),Burns & McDonnell,58300,7500,50800
"Moran, Jerry",(R),AT&T Inc,47000,47000,0
"Moran, Jerry",(R),Comcast Corp,41250,40000,1250
"Moran, Jerry",(R),Dickinson County Bank,41000,0,41000
"Moran, Jerry",(R),Kansas City Southern,40848,10000,30848
"Moran, Jerry",(R),DISH Network,40300,27500,12800
"Moran, Jerry",(R),Senior Star,40000,0,40000
"Moran, Jerry",(R),FedEx Corp,38900,33500,5400
"Moran, Jerry",(R),Air Line Pilots Assn,37000,37000,0
"Moran, Jerry",(R),American Hotel & Lodging Assn,36000,36000,0
"Moran, Jerry",(R),United Parcel Service,35500,35500,0
"Moran, Jerry",(R),Poarch Band of Creek Indians,35400,0,35400
"Moran, Jerry",(R),NCTA The Internet & Television Assn,35250,35000,250
"Moran, Jerry",(R),Automotive Free International Trade PAC,35000,35000,0
"Moran, Jerry",(R),Honeywell International,35000,35000,0
"Moran, Jerry",(R),Independent Community Bankers of America,35000,33500,1500
"Moran, Jerry",(R),National Assn of Real Estate Investment Trusts,35000,35000,0
"Moran, Jerry",(R),National Multifamily Housing Council,35000,35000,0
"Moran, Jerry",(R),Lockheed Martin,34000,34000,0
"Moran, Jerry",(R),Mortgage Bankers Assn,34000,33000,1000
"Moran, Jerry",(R),National Assn of Broadcasters,33500,30500,3000
"Moran, Jerry",(R),Deloitte LLP,33100,31000,2100
"Moran, Jerry",(R),Independent Insurance Agents & Brokers of America,33000,33000,0
"Moran, Jerry",(R),CSX Corp,32500,32500,0
"Moran, Jerry",(R),National Air Traffic Controllers Assn,31500,31500,0
"Moran, Jerry",(R),Google Inc,31200,27500,3700
"Moran, Jerry",(R),General Motors,31000,31000,0
"Moran, Jerry",(R),Chickasaw Nation,30600,0,30600
"Moran, Jerry",(R),American Bankers Assn,30450,30000,450
"Moran, Jerry",(R),American Physical Therapy Assn,30000,30000,0
"Moran, Jerry",(R),National Beer Wholesalers Assn,30000,30000,0
"Moran, Jerry",(R),Norfolk Southern,30000,30000,0
"Moran, Jerry",(R),Koch Industries,29400,10000,19400
"Moran, Jerry",(R),Van Scoyoc Assoc,29319,1469,27850
"Moran, Jerry",(R),Amgen Inc,28750,27500,1250
"Moran, Jerry",(R),NextEra Energy,28500,9000,19500
"Moran, Jerry",(R),Pfizer Inc,28500,28500,0
"Moran, Jerry",(R),Telephone & Data Systems Inc,28500,23500,5000
"Moran, Jerry",(R),Grant Thornton LLP,27850,22500,5350
"Moran, Jerry",(R),National Auto Dealers Assn,27500,27500,0
"Moran, Jerry",(R),Charter Communications,26500,26500,0
"Moran, Jerry",(R),National Assn of Realtors,26500,26500,0
"Moran, Jerry",(R),Northrop Grumman,26275,26000,275
"Moran, Jerry",(R),Polsinelli PC,26225,3500,22725
"Moran, Jerry",(R),Barona Band of Mission Indians,25800,0,25800
"Moran, Jerry",(R),Triwest Healthcare Alliance,25400,500,24900
"Moran, Jerry",(R),T-Mobile USA,25250,14750,10500
"Moran, Jerry",(R),Textron Inc,25100,25000,100
"Moran, Jerry",(R),National Assn of Convenience Stores,25000,25000,0
"Moran, Jerry",(R),American Trucking Assns,24950,16000,8950
"Moran, Jerry",(R),Crawford Group,24500,10000,14500
"Moran, Jerry",(R),Walmart Inc,23525,23500,25
"Moran, Jerry",(R),Ford Motor Co,23500,23500,0
"Moran, Jerry",(R),MetLife Inc,23500,23000,500
"Moran, Jerry",(R),Pechanga Band of Luiseno Mission Indians,23100,0,23100
"Moran, Jerry",(R),American Assn of Orthopaedic Surgeons,22500,15000,7500
"Moran, Jerry",(R),American Seniors Housing Assn,22500,22500,0
"Moran, Jerry",(R),California Dairies Inc,22500,22500,0
"Moran, Jerry",(R),HollyFrontier Corp,21000,15000,6000
"Moran, Jerry",(R),Shakopee Mdewakanton Sioux Community,20800,0,20800
"Moran, Jerry",(R),Sierra Nevada Corp,20800,18000,2800
"Moran, Jerry",(R),Macerich Co,20600,0,20600
"Moran, Jerry",(R),Live Nation Entertainment,20500,0,20500
"Moran, Jerry",(R),Koch Inc,20400,15000,5400
"Moran, Jerry",(R),Yocha Dehe Wintun Nation,20300,0,20300
"Moran, Jerry",(R),State Street Bank & Trust,20250,10000,10250
"Moran, Jerry",(R),Merck & Co,20000,20000,0
"Moran, Jerry",(R),Nebraska Sandhills PAC,20000,20000,0
"Moran, Jerry",(R),Oracle Cerner,20000,20000,0
"Moran, Jerry",(R),Woodbranch Investments,20000,0,20000
"Moran, Jerry",(R),National Cotton Council,19750,13250,6500
"Moran, Jerry",(R),Blue Cross/Blue Shield,19500,17000,2500
"Moran, Jerry",(R),Wells Fargo,19000,19000,0
"Moran, Jerry",(R),Herzog,18600,5000,13600
"Moran, Jerry",(R),Asurion Corp,18598,5000,13598
"Moran, Jerry",(R),Smiths Group Services Corp,18500,18500,0
"Moran, Jerry",(R),Hilltop Holdings,18400,0,18400
"Moran, Jerry",(R),Farm Credit Council,18250,18250,0
"Moran, Jerry",(R),Bayer AG,18000,18000,0
"Moran, Jerry",(R),Sinclair Broadcast Group,18000,3000,15000
"Moran, Jerry",(R),National Community Pharmacists Assn,17750,17500,250
"Moran, Jerry",(R),Syngenta Corp,17700,12700,5000
"Moran, Jerry",(R),Hallmark Cards,17504,0,17504
"Moran, Jerry",(R),NTCA/Rural Broadband Assn,17500,17500,0
"Moran, Jerry",(R),Securities Industry & Financial Mkt Assn,17500,17500,0
"Moran, Jerry",(R),Innovative Livestock Services,17400,0,17400
"Moran, Jerry",(R),Watco Companies,17350,0,17350
"Moran, Jerry",(R),Microsoft Corp,17300,14500,2800
"Moran, Jerry",(R),Verizon Communications,17000,17000,0
"Moran, Jerry",(R),Tunica-Biloxi Tribe of Louisiana,16800,0,16800
"Moran, Jerry",(R),Council of Insurance Agents & Brokers,16500,16500,0
"Moran, Jerry",(R),McCarthy Auto Group,16500,0,16500
"Moran, Jerry",(R),American Express,16000,16000,0
"Moran, Jerry",(R),American Financial Services Assn,16000,16000,0
"Moran, Jerry",(R),National Sorghum Producers,16000,13500,2500
"Murkowski, Lisa",(R),Clearpath Foundation,71600,0,71600
"Murkowski, Lisa",(R),NextEra Energy,63250,43000,20250
"Murkowski, Lisa",(R),Pinnacle West Capital,62450,43000,19450
"Murkowski, Lisa",(R),PG&E Corp,60650,29000,31650
"Murkowski, Lisa",(R),Cheniere Energy,52400,5000,47400
"Murkowski, Lisa",(R),Sempra Energy,51450,21750,29700
"Murkowski, Lisa",(R),Delta Air Lines,51200,45000,6200
"Murkowski, Lisa",(R),Occidental Petroleum,47600,23500,24100
"Murkowski, Lisa",(R),Southern Co,46700,39000,7700
"Murkowski, Lisa",(R),Blue Cross/Blue Shield,46275,35500,10775
"Murkowski, Lisa",(R),FedEx Corp,46000,35000,11000
"Murkowski, Lisa",(R),ConocoPhillips,45950,7400,38550
"Murkowski, Lisa",(R),Northwest Alaska Native Assn,44200,40000,4200
"Murkowski, Lisa",(R),Alaska Air Group,43515,11000,32515
"Murkowski, Lisa",(R),RTX Corp,43000,43000,0
"Murkowski, Lisa",(R),Elliott Management,42800,0,42800
"Murkowski, Lisa",(R),National Assn of Realtors,41500,39000,2500
"Murkowski, Lisa",(R),National Rural Electric Cooperative Assn,40200,36000,4200
"Murkowski, Lisa",(R),Energy Transfer Partners,40050,5000,35050
"Murkowski, Lisa",(R),National Assn of Home Builders,40000,40000,0
"Murkowski, Lisa",(R),Trident Seafoods,39750,2700,37050
"Murkowski, Lisa",(R),Saltchuk,39600,9000,30600
"Murkowski, Lisa",(R),BP,39350,16000,23350
"Murkowski, Lisa",(R),Northrop Grumman,38225,35500,2725
"Murkowski, Lisa",(R),Wine & Spirits Wholesalers of America,38000,38000,0
"Murkowski, Lisa",(R),PPL Corp,37750,37000,750
"Murkowski, Lisa",(R),Dominion Energy,37500,34500,3000
"Murkowski, Lisa",(R),Laborers Union,37500,37500,0
"Murkowski, Lisa",(R),Exelon Corp,37200,34500,2700
"Murkowski, Lisa",(R),National Multifamily Housing Council,37000,37000,0
"Murkowski, Lisa",(R),CSX Corp,36000,36000,0
"Murkowski, Lisa",(R),KKR & Co,35610,0,35610
"Murkowski, Lisa",(R),Air Line Pilots Assn,35000,35000,0
"Murkowski, Lisa",(R),American Hospital Assn,35000,35000,0
"Murkowski, Lisa",(R),Automotive Free International Trade PAC,35000,35000,0
"Murkowski, Lisa",(R),Chevron Corp,34800,12000,22800
"Murkowski, Lisa",(R),Energy Capital Partners,33500,33500,0
"Murkowski, Lisa",(R),General Communication Inc,33400,22500,10900
"Murkowski, Lisa",(R),Carnival Corp,32950,6500,26450
"Murkowski, Lisa",(R),DTE Energy,32458,10500,21958
"Murkowski, Lisa",(R),General Motors,32125,32125,0
"Murkowski, Lisa",(R),Pacific Seafood Processors Assn,30900,18000,12900
"Murkowski, Lisa",(R),Entergy Corp,30754,16000,14754
"Murkowski, Lisa",(R),Edison Chouest Offshore,30500,0,30500
"Murkowski, Lisa",(R),Huntington Ingalls Industries,30500,30500,0
"Murkowski, Lisa",(R),Cow Creek Band of Umpqua Indians,30400,0,30400
"Murkowski, Lisa",(R),Eversource Energy,30000,30000,0
"Murkowski, Lisa",(R),Vail Resorts,30000,30000,0
"Murkowski, Lisa",(R),American Congress of Obstetricians & Gynecologists,29500,29500,0
"Murkowski, Lisa",(R),Berkshire Hathaway,29200,26000,3200
"Murkowski, Lisa",(R),Vigor Industrial,29000,18500,10500
"Murkowski, Lisa",(R),Deloitte LLP,28710,25000,3710
"Murkowski, Lisa",(R),Google Inc,28700,21000,7700
"Murkowski, Lisa",(R),American College of Emergency Physicians,28500,28500,0
"Murkowski, Lisa",(R),National Air Traffic Controllers Assn,27500,27500,0
"Murkowski, Lisa",(R),Amway/Alticor Inc,27000,0,27000
"Murkowski, Lisa",(R),General Dynamics,27000,27000,0
"Murkowski, Lisa",(R),Steptoe & Johnson,27000,12500,14500
"Murkowski, Lisa",(R),Barrick Gold Corp,26500,25000,1500
"Murkowski, Lisa",(R),Honeywell International,26000,26000,0
"Murkowski, Lisa",(R),Fortis Inc,25500,25500,0
"Murkowski, Lisa",(R),Home Depot,25000,25000,0
"Murkowski, Lisa",(R),NorPAC,24950,0,24950
"Murkowski, Lisa",(R),Comcast Corp,24500,24500,0
"Murkowski, Lisa",(R),Van Ness Feldman,24250,7000,17250
"Murkowski, Lisa",(R),BASF Corp,24000,24000,0
"Murkowski, Lisa",(R),"Bryan, Cave et al",24000,24000,0
"Murkowski, Lisa",(R),Pioneer Natural Resources,23700,2000,21700
"Murkowski, Lisa",(R),Shakopee Mdewakanton Sioux Community,23700,0,23700
"Murkowski, Lisa",(R),Walmart Inc,23525,23500,25
"Murkowski, Lisa",(R),United Parcel Service,23510,23500,10
"Murkowski, Lisa",(R),Credit Union National Assn,23000,23000,0
"Murkowski, Lisa",(R),KPMG LLP,22500,22500,0
"Murkowski, Lisa",(R),National Assn of Convenience Stores,22500,22500,0
"Murkowski, Lisa",(R),"Robertson, Monagle & Eastaugh",22200,0,22200
"Murkowski, Lisa",(R),Edison Electric Institute,22000,21000,1000
"Murkowski, Lisa",(R),Ernst & Young,21500,20000,1500
"Murkowski, Lisa",(R),Lynden Inc,21500,0,21500
"Murkowski, Lisa",(R),Ford Motor Co,20500,20500,0
"Murkowski, Lisa",(R),Continuing America's Strength & Security,20000,20000,0
"Murkowski, Lisa",(R),Lockheed Martin,20000,20000,0
"Murkowski, Lisa",(R),National Rural Water Assn,20000,20000,0
"Murkowski, Lisa",(R),Operating Engineers Union,20000,20000,0
"Murkowski, Lisa",(R),General Electric,19700,14000,5700
"Murkowski, Lisa",(R),BlueWater Strategies,19599,0,19599
"Murkowski, Lisa",(R),Dow Inc,19500,19500,0
"Murkowski, Lisa",(R),Snoqualmie Indian Tribe,19200,0,19200
"Murkowski, Lisa",(R),Chugach Alaska,18550,16500,2050
"Murkowski, Lisa",(R),Nuclear Energy Institute,18000,16500,1500
"Murkowski, Lisa",(R),Bill & Melinda Gates Foundation,17700,0,17700
"Murkowski, Lisa",(R),GE Aerospace,17700,15000,2700
"Murkowski, Lisa",(R),International Paper,17500,17500,0
"Murkowski, Lisa",(R),Marathon Petroleum,17500,17500,0
"Murkowski, Lisa",(R),Burns & McDonnell,17000,17000,0
"Murkowski, Lisa",(R),National Fisheries Institute,17000,17000,0
"Murkowski, Lisa",(R),Exxon Mobil,16625,8625,8000
"Murkowski, Lisa",(R),Marathon Oil,16600,6000,10600
"Murkowski, Lisa",(R),BWX Technologies,16500,16500,0
"Murkowski, Lisa",(R),Sierra Pacific Industries,16500,0,16500
"Murkowski, Lisa",(R),Blank Rome LLP,16450,6750,9700
"Murphy, Christopher S",(D),"Paul, Weiss et al",150103,0,150103
"Murphy, Christopher S",(D),Yale University,135207,0,135207
"Murphy, Christopher S",(D),J Street,61545,0,61545
"Murphy, Christopher S",(D),JPMorgan Chase & Co,56772,12500,44272
"Murphy, Christopher S",(D),General Dynamics,51415,30000,21415
"Murphy, Christopher S",(D),RTX Corp,49498,28500,20998
"Murphy, Christopher S",(D),Charter Communications,46008,25000,21008
"Murphy, Christopher S",(D),CVS Health,44967,31000,13967
"Murphy, Christopher S",(D),AT&T Inc,43904,9000,34904
"Murphy, Christopher S",(D),Sullivan & Cromwell,42495,0,42495
"Murphy, Christopher S",(D),Goldman Sachs,39645,20000,19645
"Murphy, Christopher S",(D),Hartford Financial Services,34241,27500,6741
"Murphy, Christopher S",(D),Morgan Stanley,33570,7500,26070
"Murphy, Christopher S",(D),Ernst & Young,32788,30000,2788
"Murphy, Christopher S",(D),"Lieff, Cabraser et al",32218,0,32218
"Murphy, Christopher S",(D),New York Life Insurance,31515,31000,515
"Murphy, Christopher S",(D),State of Connecticut,31036,0,31036
"Murphy, Christopher S",(D),PricewaterhouseCoopers,30944,30000,944
"Murphy, Christopher S",(D),KPMG LLP,30640,30000,640
"Murphy, Christopher S",(D),UBS AG,30405,30000,405
"Murphy, Christopher S",(D),Honeywell International,30299,30000,299
"Murphy, Christopher S",(D),American College of Emergency Physicians,30000,30000,0
"Murphy, Christopher S",(D),Investment Co Institute,30000,30000,0
"Murphy, Christopher S",(D),PJT Partners,29775,0,29775
"Murphy, Christopher S",(D),Harvard University,29595,0,29595
"Murphy, Christopher S",(D),University of Connecticut,29243,0,29243
"Murphy, Christopher S",(D),Prudential Financial,28403,27500,903
"Murphy, Christopher S",(D),Veritas Capital,28121,7500,20621
"Murphy, Christopher S",(D),Simmons Hanly Conroy,27700,0,27700
"Murphy, Christopher S",(D),Citigroup Inc,27632,8500,19132
"Murphy, Christopher S",(D),Mortgage Bankers Assn,27568,27500,68
"Murphy, Christopher S",(D),Lockheed Martin,26636,25000,1636
"Murphy, Christopher S",(D),Microsoft Corp,26224,11500,14724
"Murphy, Christopher S",(D),Hartford Health Care,26163,0,26163
"Murphy, Christopher S",(D),Silver Lake Partners,25305,0,25305
"Murphy, Christopher S",(D),American Institute of CPAs,25000,25000,0
"Murphy, Christopher S",(D),Deloitte LLP,24650,20000,4650
"Murphy, Christopher S",(D),Pitney Bowes Inc,24097,10500,13597
"Murphy, Christopher S",(D),Shipman & Goodwin,23948,0,23948
"Murphy, Christopher S",(D),Massachusetts Mutual Life Insurance,23695,20000,3695
"Murphy, Christopher S",(D),Cigna Corp,23078,20000,3078
"Murphy, Christopher S",(D),Columbia University,22870,0,22870
"Murphy, Christopher S",(D),Travelers Companies,22652,22500,152
"Murphy, Christopher S",(D),Council of Insurance Agents & Brokers,22500,22500,0
"Murphy, Christopher S",(D),National Multifamily Housing Council,22500,22500,0
"Murphy, Christopher S",(D),MetLife Inc,21401,17500,3901
"Murphy, Christopher S",(D),Home Depot,21244,20000,1244
"Murphy, Christopher S",(D),"Akin, Gump et al",21110,2500,18610
"Murphy, Christopher S",(D),United Parcel Service,20824,20500,324
"Murphy, Christopher S",(D),Apax Partners,20800,0,20800
"Murphy, Christopher S",(D),Bessemer Venture Partners,20800,0,20800
"Murphy, Christopher S",(D),Independent Insurance Agents & Brokers of America,20500,20500,0
"Murphy, Christopher S",(D),International Brotherhood of Electrical Workers,20498,20000,498
"Murphy, Christopher S",(D),Alternative Investment Group,20400,0,20400
"Murphy, Christopher S",(D),"Koskoff, Koskoff & Bieder",20145,0,20145
"Murphy, Christopher S",(D),American Health Care Assn,20000,20000,0
"Murphy, Christopher S",(D),Woodbranch Investments,20000,0,20000
"Murphy, Christopher S",(D),Cherokee Nation,19900,0,19900
"Murphy, Christopher S",(D),"Simpson, Thacher & Bartlett",19553,0,19553
"Murphy, Christopher S",(D),"Quinn, Emanuel et al",19250,0,19250
"Murphy, Christopher S",(D),"Gori, Julian & Assoc",18900,0,18900
"Murphy, Christopher S",(D),American Optometric Assn,18500,18500,0
"Murphy, Christopher S",(D),Amazon.com,18219,11000,7219
"Murphy, Christopher S",(D),Bank of America,17598,0,17598
"Murphy, Christopher S",(D),Northrop Grumman,17537,16000,1537
"Murphy, Christopher S",(D),NorPAC,17450,0,17450
"Murphy, Christopher S",(D),UnitedHealth Group,17333,6000,11333
"Murphy, Christopher S",(D),General Electric,17153,8000,9153
"Murphy, Christopher S",(D),Mayer Brown Llp,16986,0,16986
"Murphy, Christopher S",(D),"Skadden, Arps et al",16919,0,16919
"Murphy, Christopher S",(D),"Silver, Golub & Teitell",16918,0,16918
"Murphy, Christopher S",(D),League of Conservation Voters,16104,8537,7567
"Murphy, Christopher S",(D),Alexander Soros Foundation,15400,0,15400
"Murphy, Christopher S",(D),Walt Disney Co,15390,9000,6390
"Murphy, Christopher S",(D),The Hartford,15311,0,15311
"Murphy, Christopher S",(D),Dominion Energy,15268,15000,268
"Murphy, Christopher S",(D),National Assn of Letter Carriers,15250,15000,250
"Murphy, Christopher S",(D),Operating Engineers Union,15000,15000,0
"Murphy, Christopher S",(D),Putnam Bridge,15000,0,15000
"Murphy, Christopher S",(D),Ironwood Partners,14950,0,14950
"Murphy, Christopher S",(D),Kirkland & Ellis,14775,0,14775
"Murphy, Christopher S",(D),Cross Sound Ferry,14650,0,14650
"Murphy, Christopher S",(D),Clifford Law Offices,14550,0,14550
"Murphy, Christopher S",(D),Connecticut State University System,14420,0,14420
"Murphy, Christopher S",(D),Global Partners LP,14300,0,14300
"Murphy, Christopher S",(D),WPP plc,14183,0,14183
"Murphy, Christopher S",(D),American Medical Assn,14048,14000,48
"Murphy, Christopher S",(D),National Assn of Realtors,14000,14000,0
"Murphy, Christopher S",(D),State of Illinois,13878,0,13878
"Murphy, Christopher S",(D),Pdt Partners,13800,0,13800
"Murphy, Christopher S",(D),"Ryan, Ryan & Deluca",13710,0,13710
"Murphy, Christopher S",(D),Capital Strategies Group,13550,0,13550
"Murphy, Christopher S",(D),Ischemix,13500,0,13500
"Murphy, Christopher S",(D),"Willkie, Farr & Gallagher",13410,0,13410
"Murphy, Christopher S",(D),Debevoise & Plimpton,13400,0,13400
"Murphy, Christopher S",(D),Segal Ventures,13100,0,13100
"Murphy, Christopher S",(D),Association for Advanced Life Underwriting,13000,13000,0
"Murphy, Christopher S",(D),Pfizer Inc,12885,0,12885
"Murphy, Christopher S",(D),Eversource Energy,12790,10000,2790
"Murphy, Christopher S",(D),Google Inc,12674,9322,3352
"Murray, Patty",(D),Microsoft Corp,142465,30000,112465
"Murray, Patty",(D),University of Washington,141269,0,141269
"Murray, Patty",(D),Blue Cross/Blue Shield,98214,68500,29714
"Murray, Patty",(D),Emily's List,91104,5000,86104
"Murray, Patty",(D),Amazon.com,85835,18000,67835
"Murray, Patty",(D),League of Conservation Voters,72361,17168,55193
"Murray, Patty",(D),Boeing Co,70012,15000,55012
"Murray, Patty",(D),Amgen Inc,68970,37500,31470
"Murray, Patty",(D),Berkshire Hathaway,65144,30000,35144
"Murray, Patty",(D),Comcast Corp,49515,35000,14515
"Murray, Patty",(D),Deloitte LLP,49371,37500,11871
"Murray, Patty",(D),K&L Gates,48797,10000,38797
"Murray, Patty",(D),Pfizer Inc,46513,41000,5513
"Murray, Patty",(D),JPMorgan Chase & Co,42731,25000,17731
"Murray, Patty",(D),Woodbranch Investments,41500,0,41500
"Murray, Patty",(D),Pacific Bioscience Labs,41200,0,41200
"Murray, Patty",(D),Abbott Laboratories,40538,40500,38
"Murray, Patty",(D),National Assn of Realtors,40500,39250,1250
"Murray, Patty",(D),Union Pacific Corp,40093,40000,93
"Murray, Patty",(D),Merck & Co,40010,35000,5010
"Murray, Patty",(D),United Airlines,39830,13000,26830
"Murray, Patty",(D),Air Line Pilots Assn,39510,39500,10
"Murray, Patty",(D),State of Washington,39167,0,39167
"Murray, Patty",(D),Honeywell International,38159,38000,159
"Murray, Patty",(D),Northrop Grumman,38000,38000,0
"Murray, Patty",(D),CVS Health,37589,36500,1089
"Murray, Patty",(D),Dell Technologies,35347,3500,31847
"Murray, Patty",(D),National Education Assn,35299,33000,2299
"Murray, Patty",(D),Costco Wholesale,35281,0,35281
"Murray, Patty",(D),AbbVie Inc,35265,35000,265
"Murray, Patty",(D),Bristol-Myers Squibb,33969,28500,5469
"Murray, Patty",(D),Weyerhaeuser Co,33828,9500,24328
"Murray, Patty",(D),Carlyle Group,33500,17500,16000
"Murray, Patty",(D),NCTA The Internet & Television Assn,33000,27500,5500
"Murray, Patty",(D),International Assn of Fire Fighters,32500,32500,0
"Murray, Patty",(D),AECOM Global,32296,11500,20796
"Murray, Patty",(D),UnitedHealth Group,32222,15000,17222
"Murray, Patty",(D),United Parcel Service,31776,31600,176
"Murray, Patty",(D),Citigroup Inc,31465,9500,21965
"Murray, Patty",(D),Mortgage Bankers Assn,31000,31000,0
"Murray, Patty",(D),Eli Lilly & Co,30150,20000,10150
"Murray, Patty",(D),Delta Air Lines,30024,22500,7524
"Murray, Patty",(D),CSX Corp,30000,30000,0
"Murray, Patty",(D),National Beer Wholesalers Assn,30000,30000,0
"Murray, Patty",(D),Norfolk Southern,30000,30000,0
"Murray, Patty",(D),Operating Engineers Union,29378,29375,3
"Murray, Patty",(D),Plumbers/Pipefitters Union,29030,29000,30
"Murray, Patty",(D),National Air Traffic Controllers Assn,29000,29000,0
"Murray, Patty",(D),Juno Therapeutics,28887,22000,6887
"Murray, Patty",(D),Intellectual Ventures LLC,28780,6500,22280
"Murray, Patty",(D),Alaska Air Group,28708,10000,18708
"Murray, Patty",(D),J Street,28330,5000,23330
"Murray, Patty",(D),Perkins Coie,28243,0,28243
"Murray, Patty",(D),International Paper,28179,22500,5679
"Murray, Patty",(D),Hewlett Packard Enterprise,28001,24000,4001
"Murray, Patty",(D),Altria Group,27650,25000,2650
"Murray, Patty",(D),American Superconductor,27600,0,27600
"Murray, Patty",(D),International Brotherhood of Electrical Workers,27203,26000,1203
"Murray, Patty",(D),Genentech Inc,27030,27000,30
"Murray, Patty",(D),Laborers Union,26500,26000,500
"Murray, Patty",(D),American Assn for Justice,26366,24500,1866
"Murray, Patty",(D),Humana Inc,25427,22500,2927
"Murray, Patty",(D),American Federation of Teachers,25029,25000,29
"Murray, Patty",(D),General Motors,25000,25000,0
"Murray, Patty",(D),National Assn of Real Estate Investment Trusts,25000,25000,0
"Murray, Patty",(D),Snoqualmie Indian Tribe,25000,0,25000
"Murray, Patty",(D),Wine & Spirits Wholesalers of America,25000,25000,0
"Murray, Patty",(D),Bill & Melinda Gates Foundation,24822,0,24822
"Murray, Patty",(D),NorPAC,24600,0,24600
"Murray, Patty",(D),Cooper House,24550,0,24550
"Murray, Patty",(D),McKesson Corp,24500,24500,0
"Murray, Patty",(D),Sanofi,24500,24000,500
"Murray, Patty",(D),Novo Nordisk,24236,24236,0
"Murray, Patty",(D),Madrona Venture Group,24207,0,24207
"Murray, Patty",(D),BAE Systems,23504,19000,4504
"Murray, Patty",(D),Bainbridge Performing Arts,23405,0,23405
"Murray, Patty",(D),"Akin, Gump et al",23280,5580,17700
"Murray, Patty",(D),RTX Corp,23239,22500,739
"Murray, Patty",(D),Bergman Draper Oslund,23050,0,23050
"Murray, Patty",(D),T-Mobile USA,22958,22000,958
"Murray, Patty",(D),Lockheed Martin,22515,22000,515
"Murray, Patty",(D),Gilead Sciences,22500,17500,5000
"Murray, Patty",(D),"City of Seattle, WA",22313,0,22313
"Murray, Patty",(D),Saltchuk Resources,22050,5500,16550
"Murray, Patty",(D),Pharmaceutical Research & Manufacturers Of America,22000,15000,7000
"Murray, Patty",(D),Battelle,21720,0,21720
"Murray, Patty",(D),Peter G Peterson Foundation,21700,0,21700
"Murray, Patty",(D),DreamWorks SKG,21600,0,21600
"Murray, Patty",(D),National Assn of Broadcasters,21500,21500,0
"Murray, Patty",(D),Verizon Communications,21427,15500,5927
"Murray, Patty",(D),EmblemHealth Inc,21036,0,21036
"Murray, Patty",(D),AFLAC Inc,21000,21500,-500
"Murray, Patty",(D),American Academy of Dermatology Assn,21000,21000,0
"Murray, Patty",(D),National Football League,21000,20000,1000
"Murray, Patty",(D),Covington & Burling,20932,10999,9933
"Murray, Patty",(D),Trident Seafoods,20463,0,20463
"Murray, Patty",(D),Puyallup Tribe of Indians,20400,0,20400
"Murray, Patty",(D),Cardinal Health,20003,20000,3
"Murray, Patty",(D),Off the Sidelines,20000,20000,0
"Murray, Patty",(D),Purpose PAC,20000,20000,0
"Ossoff, Jon",(D),Alphabet Inc,1136947,0,1136947
"Ossoff, Jon",(D),University of California,739086,0,739086
"Ossoff, Jon",(D),Microsoft Corp,397769,0,397769
"Ossoff, Jon",(D),Apple Inc,378787,0,378787
"Ossoff, Jon",(D),Amazon.com,357915,0,357915
"Ossoff, Jon",(D),Meta,269578,0,269578
"Ossoff, Jon",(D),US Government,244609,0,244609
"Ossoff, Jon",(D),Kaiser Permanente,240184,0,240184
"Ossoff, Jon",(D),Emory University,222186,0,222186
"Ossoff, Jon",(D),Stanford University,221356,0,221356
"Ossoff, Jon",(D),Walt Disney Co,211046,0,211046
"Ossoff, Jon",(D),Harvard University,207872,0,207872
"Ossoff, Jon",(D),State of California,197007,0,197007
"Ossoff, Jon",(D),Democracy Engine,192792,0,192792
"Ossoff, Jon",(D),J Street,184734,759,183975
"Ossoff, Jon",(D),US Dept of Health & Human Services,184188,0,184188
"Ossoff, Jon",(D),IBM Corp,179486,0,179486
"Ossoff, Jon",(D),University of Washington,153401,0,153401
"Ossoff, Jon",(D),"City of New York, NY",151374,0,151374
"Ossoff, Jon",(D),Warner Brothers Discovery,150796,0,150796
"Ossoff, Jon",(D),Columbia University,147851,0,147851
"Ossoff, Jon",(D),Salesforce.Com,132794,0,132794
"Ossoff, Jon",(D),Oracle Corp,132302,0,132302
"Ossoff, Jon",(D),US Dept of Veterans Affairs,124114,0,124114
"Ossoff, Jon",(D),Comcast Corp,121323,0,121323
"Ossoff, Jon",(D),New York University,118956,0,118956
"Ossoff, Jon",(D),Mass General Brigham,115235,0,115235
"Ossoff, Jon",(D),Massachusetts Institute of Technology,113984,0,113984
"Ossoff, Jon",(D),City University of New York,111538,0,111538
"Ossoff, Jon",(D),US Dept of Defense,111194,0,111194
"Ossoff, Jon",(D),University of Texas,110552,0,110552
"Ossoff, Jon",(D),University of Pennsylvania,109219,0,109219
"Ossoff, Jon",(D),National Amusements Inc,106326,0,106326
"Ossoff, Jon",(D),Yale University,103454,0,103454
"Ossoff, Jon",(D),Wells Fargo,95139,0,95139
"Ossoff, Jon",(D),California State University,94548,0,94548
"Ossoff, Jon",(D),University of Michigan,93652,0,93652
"Ossoff, Jon",(D),AT&T Inc,91042,0,91042
"Ossoff, Jon",(D),University of Southern California,87639,0,87639
"Ossoff, Jon",(D),Wilmerhale Llp,87146,0,87146
"Ossoff, Jon",(D),University of Maryland,86570,0,86570
"Ossoff, Jon",(D),Johns Hopkins University,86455,0,86455
"Ossoff, Jon",(D),Deloitte LLP,85596,0,85596
"Ossoff, Jon",(D),Boeing Co,81150,0,81150
"Ossoff, Jon",(D),Blue Cross/Blue Shield,80125,0,80125
"Ossoff, Jon",(D),University of Georgia,79353,0,79353
"Ossoff, Jon",(D),US Dept of Commerce,79119,0,79119
"Ossoff, Jon",(D),US Dept of State,78542,0,78542
"Ossoff, Jon",(D),Intel Corp,78528,0,78528
"Ossoff, Jon",(D),Netflix Inc,74899,0,74899
"Ossoff, Jon",(D),University of Chicago,74474,0,74474
"Ossoff, Jon",(D),JPMorgan Chase & Co,74424,0,74424
"Ossoff, Jon",(D),Cisco Systems,73993,0,73993
"Ossoff, Jon",(D),University of Wisconsin,73731,0,73731
"Ossoff, Jon",(D),University of Illinois,73703,0,73703
"Ossoff, Jon",(D),US Army,71400,0,71400
"Ossoff, Jon",(D),University of Minnesota,70743,0,70743
"Ossoff, Jon",(D),UnitedHealth Group,70694,0,70694
"Ossoff, Jon",(D),US Navy,70378,0,70378
"Ossoff, Jon",(D),Georgia Tech,69861,0,69861
"Ossoff, Jon",(D),University of Colorado,69844,0,69844
"Ossoff, Jon",(D),State University of New York,69362,0,69362
"Ossoff, Jon",(D),Delta Air Lines,69215,0,69215
"Ossoff, Jon",(D),Cornell University,69158,0,69158
"Ossoff, Jon",(D),University of North Carolina,67146,0,67146
"Ossoff, Jon",(D),US Dept of Justice,66833,0,66833
"Ossoff, Jon",(D),NVIDIA Corp,65750,0,65750
"Ossoff, Jon",(D),Northwestern University,65574,0,65574
"Ossoff, Jon",(D),Latham & Watkins,65365,0,65365
"Ossoff, Jon",(D),Adobe Inc,65258,0,65258
"Ossoff, Jon",(D),Accenture,64729,0,64729
"Ossoff, Jon",(D),US Postal Service,64682,0,64682
"Ossoff, Jon",(D),McKinsey & Co,64548,0,64548
"Ossoff, Jon",(D),US Dept of Energy,64206,0,64206
"Ossoff, Jon",(D),Rutgers University,63363,0,63363
"Ossoff, Jon",(D),Sony Corp,63205,0,63205
"Ossoff, Jon",(D),Duke University,62672,0,62672
"Ossoff, Jon",(D),Georgetown University,62270,0,62270
"Ossoff, Jon",(D),US Environmental Protection Agency,61004,0,61004
"Ossoff, Jon",(D),Sidley Austin LLP,60836,0,60836
"Ossoff, Jon",(D),Kirkland & Ellis,60647,0,60647
"Ossoff, Jon",(D),Bank of America,60279,0,60279
"Ossoff, Jon",(D),"Los Angeles County, CA",60259,0,60259
"Ossoff, Jon",(D),State of New York,59040,0,59040
"Ossoff, Jon",(D),Lockheed Martin,58729,0,58729
"Ossoff, Jon",(D),"City & County of San Francisco, CA",58589,0,58589
"Ossoff, Jon",(D),Roche Holdings,58056,0,58056
"Ossoff, Jon",(D),Block Inc,58018,0,58018
"Ossoff, Jon",(D),Morgan Stanley,57831,0,57831
"Ossoff, Jon",(D),"Simpson, Thacher & Bartlett",57437,0,57437
"Ossoff, Jon",(D),Anywhere Real Estate,57318,0,57318
"Ossoff, Jon",(D),Twitter,56914,0,56914
"Ossoff, Jon",(D),Georgia State University,55818,0,55818
"Ossoff, Jon",(D),Stripe Inc,54404,0,54404
"Ossoff, Jon",(D),Boston University,53707,0,53707
"Ossoff, Jon",(D),University of Pittsburgh,53447,0,53447
"Ossoff, Jon",(D),Indiana University,52438,0,52438
"Ossoff, Jon",(D),Ernst & Young,52311,0,52311
"Ossoff, Jon",(D),Broadcom Inc,51388,0,51388
"Ossoff, Jon",(D),Morgan Lewis Llp,51114,0,51114
"Padilla, Alex",(D),Hueston Hennigan Llp,135400,0,135400
"Padilla, Alex",(D),Democracy Engine,122230,0,122230
"Padilla, Alex",(D),Comcast Corp,91225,20000,71225
"Padilla, Alex",(D),Edison International,90365,25000,65365
"Padilla, Alex",(D),"Cotchett, Pitre & McCarthy",71950,0,71950
"Padilla, Alex",(D),E&J Gallo Winery,60575,0,60575
"Padilla, Alex",(D),Sv Angel LLC,50600,0,50600
"Padilla, Alex",(D),"Dreyer, Babich et al",38700,0,38700
"Padilla, Alex",(D),"Robbins, Geller et al",37950,0,37950
"Padilla, Alex",(D),"Kleiner, Perkins et al",37600,0,37600
"Padilla, Alex",(D),Blue Cross/Blue Shield,35650,17000,18650
"Padilla, Alex",(D),State of California,35488,0,35488
"Padilla, Alex",(D),General Atomics,35403,15000,20403
"Padilla, Alex",(D),Parkia Inc,34800,0,34800
"Padilla, Alex",(D),University of California,33448,0,33448
"Padilla, Alex",(D),Harbor Freight Tools,32900,0,32900
"Padilla, Alex",(D),Alphabet Inc,31175,9500,21675
"Padilla, Alex",(D),Airbnb Inc,30700,2500,28200
"Padilla, Alex",(D),Kaiser Permanente,30661,0,30661
"Padilla, Alex",(D),Masimo Corp,29834,5634,24200
"Padilla, Alex",(D),Advanced Nutrients,29000,0,29000
"Padilla, Alex",(D),Capitol Advocacy,28500,0,28500
"Padilla, Alex",(D),Lyft Inc,28300,5000,23300
"Padilla, Alex",(D),Live Nation Entertainment,28200,0,28200
"Padilla, Alex",(D),Greenberg Traurig LLP,27550,10000,17550
"Padilla, Alex",(D),O'Melveny & Myers,27375,5500,21875
"Padilla, Alex",(D),AT&T Inc,27050,20000,7050
"Padilla, Alex",(D),TelevisaUnivision,26400,2500,23900
"Padilla, Alex",(D),DLA Piper,26100,4500,21600
"Padilla, Alex",(D),Operating Engineers Union,26000,26000,0
"Padilla, Alex",(D),Telacu,25050,0,25050
"Padilla, Alex",(D),Anheuser-Busch,23600,22500,1100
"Padilla, Alex",(D),Omnicom Group,23550,0,23550
"Padilla, Alex",(D),Covington & Burling,23400,5000,18400
"Padilla, Alex",(D),Andell Holdings,23200,0,23200
"Padilla, Alex",(D),Lian Corp,23200,0,23200
"Padilla, Alex",(D),Pisces Inc,23200,0,23200
"Padilla, Alex",(D),Walt Disney Co,22532,2000,20532
"Padilla, Alex",(D),Qualcomm Inc,22500,10000,12500
"Padilla, Alex",(D),Silver Lake Partners,22400,10000,12400
"Padilla, Alex",(D),Capital Group Companies,22300,10000,12300
"Padilla, Alex",(D),"Brownstein, Hyatt et al",22250,3000,19250
"Padilla, Alex",(D),Georgetown University,22000,0,22000
"Padilla, Alex",(D),National Assn of Realtors,22000,20000,2000
"Padilla, Alex",(D),Barona Band of Mission Indians,21600,0,21600
"Padilla, Alex",(D),Karla T Jurvetson MD,21600,0,21600
"Padilla, Alex",(D),Laborers Union,21000,20000,1000
"Padilla, Alex",(D),Motion Picture Assn,21000,10000,11000
"Padilla, Alex",(D),Boundary Stone Partners,20500,0,20500
"Padilla, Alex",(D),"Akin, Gump et al",20350,2500,17850
"Padilla, Alex",(D),"Korshak, Kracoff et al",20300,0,20300
"Padilla, Alex",(D),Manzanita Capital,20300,0,20300
"Padilla, Alex",(D),Air Line Pilots Assn,20000,20000,0
"Padilla, Alex",(D),General Motors,20000,20000,0
"Padilla, Alex",(D),HDR Inc,20000,20000,0
"Padilla, Alex",(D),Impact (Schumer),20000,20000,0
"Padilla, Alex",(D),International Assn of Fire Fighters,20000,20000,0
"Padilla, Alex",(D),Prairie PAC,20000,20000,0
"Padilla, Alex",(D),Professional Engineers in California Government,20000,20000,0
"Padilla, Alex",(D),Purpose PAC,20000,20000,0
"Padilla, Alex",(D),Wine Institute,20000,20000,0
"Padilla, Alex",(D),Latham & Watkins,19500,0,19500
"Padilla, Alex",(D),Pechanga Band of Luiseno Mission Indians,19000,0,19000
"Padilla, Alex",(D),Bloom Energy,18300,10800,7500
"Padilla, Alex",(D),Royal Business Bank,18200,0,18200
"Padilla, Alex",(D),California Strategies,18000,0,18000
"Padilla, Alex",(D),HP Inc,17950,0,17950
"Padilla, Alex",(D),America's Credit Unions,17850,15000,2850
"Padilla, Alex",(D),BearStar Strategies,17700,0,17700
"Padilla, Alex",(D),Wonderful Co,17650,0,17650
"Padilla, Alex",(D),Charter Communications,17500,17500,0
"Padilla, Alex",(D),"Quinn, Emanuel et al",17500,0,17500
"Padilla, Alex",(D),Anthropocene Institute,17400,0,17400
"Padilla, Alex",(D),Gilbert & Jacki Cisneros Foundation,17400,0,17400
"Padilla, Alex",(D),Kindbody,17400,0,17400
"Padilla, Alex",(D),Manpowergroup,17400,0,17400
"Padilla, Alex",(D),Shorenstein,17400,0,17400
"Padilla, Alex",(D),Quotidian Gallery,17200,0,17200
"Padilla, Alex",(D),Apollo Global Management,17032,6000,11032
"Padilla, Alex",(D),University of Southern California,17000,0,17000
"Padilla, Alex",(D),Cherokee Nation,16600,0,16600
"Padilla, Alex",(D),Clinton Reilly Holdings,16600,0,16600
"Padilla, Alex",(D),Federated Indians of Graton Rancheria,16600,0,16600
"Padilla, Alex",(D),Santa Ynez Band of Chumash Indians,16500,0,16500
"Padilla, Alex",(D),Susman Godfrey Llp,16500,0,16500
"Padilla, Alex",(D),Universal Music Group,16500,5000,11500
"Padilla, Alex",(D),Stanford University,16300,0,16300
"Padilla, Alex",(D),"Glaser, Weil et al",16200,0,16200
"Padilla, Alex",(D),"Gibson, Dunn & Crutcher",16050,0,16050
"Padilla, Alex",(D),Holland & Knight,16000,1500,14500
"Padilla, Alex",(D),Flex Logix Technologies,15800,0,15800
"Padilla, Alex",(D),Shingle Springs Band of Miwok Indians,15800,0,15800
"Padilla, Alex",(D),Yin McDonald'S,15800,0,15800
"Padilla, Alex",(D),Power Rogers Llp,15600,0,15600
"Padilla, Alex",(D),Doordash Inc,15500,2900,12600
"Padilla, Alex",(D),United Food & Commercial Workers Union,15500,15000,500
"Padilla, Alex",(D),American Council of Engineering Cos,15000,15000,0
"Padilla, Alex",(D),California Westside Farmers Inc,15000,15000,0
"Padilla, Alex",(D),Carpenters & Joiners Union,15000,15000,0
"Padilla, Alex",(D),Forward Together PAC,15000,15000,0
"Paul, Rand",(R),Huffines Communities,87800,0,87800
"Paul, Rand",(R),Club for Growth,77630,0,77630
"Paul, Rand",(R),AT&T Inc,49750,48000,1750
"Paul, Rand",(R),RagingWire Enterprise Solutions,45975,0,45975
"Paul, Rand",(R),Forcht Group of Kentucky,45450,0,45450
"Paul, Rand",(R),Susquehanna International Group,41200,0,41200
"Paul, Rand",(R),Pivotal Group,40998,0,40998
"Paul, Rand",(R),Curves International,40800,0,40800
"Paul, Rand",(R),Brown-Forman Corp,39100,14000,25100
"Paul, Rand",(R),LHC Group,37650,0,37650
"Paul, Rand",(R),America's Credit Unions,35000,32500,2500
"Paul, Rand",(R),Morning Star Co,34200,0,34200
"Paul, Rand",(R),Phonoscope Communications,32300,0,32300
"Paul, Rand",(R),Herring Networks,32200,0,32200
"Paul, Rand",(R),Golden Age Farm,31800,0,31800
"Paul, Rand",(R),TAMKO Building Products,31800,0,31800
"Paul, Rand",(R),United Parcel Service,30848,30000,848
"Paul, Rand",(R),Sara Story Design,30600,0,30600
"Paul, Rand",(R),American Soc Cataract/Refractive Surgery,30000,30000,0
"Paul, Rand",(R),Vibrant Technologies,29418,0,29418
"Paul, Rand",(R),Altria Group,26500,26000,500
"Paul, Rand",(R),Humphreys & Partners Architects,26250,0,26250
"Paul, Rand",(R),Galileo Global Advisors,25900,0,25900
"Paul, Rand",(R),Michigan Cat,25800,0,25800
"Paul, Rand",(R),Nevada Retina Assoc,25400,0,25400
"Paul, Rand",(R),CD Norberg & Assoc,25000,0,25000
"Paul, Rand",(R),Mason Capital Management,25000,0,25000
"Paul, Rand",(R),Google Inc,24750,22500,2250
"Paul, Rand",(R),Amgen Inc,24100,15500,8600
"Paul, Rand",(R),Khorus,24000,0,24000
"Paul, Rand",(R),College Loan Corp,23500,0,23500
"Paul, Rand",(R),Microsoft Corp,23340,19500,3840
"Paul, Rand",(R),Sun Tan City,21600,0,21600
"Paul, Rand",(R),Grubbs Nissan,21200,0,21200
"Paul, Rand",(R),Harvey Gulf International Marine,21200,0,21200
"Paul, Rand",(R),Hung Vu Auditor LLC,21200,0,21200
"Paul, Rand",(R),Q Sushi,21200,0,21200
"Paul, Rand",(R),Conair Corp,20800,0,20800
"Paul, Rand",(R),Cato Institute,20600,0,20600
"Paul, Rand",(R),Comcast Corp,20500,20000,500
"Paul, Rand",(R),Entertrainment Junction,20400,0,20400
"Paul, Rand",(R),Orchard Global Asset Management,20400,0,20400
"Paul, Rand",(R),R&S Northeast LLC,20400,0,20400
"Paul, Rand",(R),National Assn for Gun Rights,20353,17908,2445
"Paul, Rand",(R),Earth Materials Holdings,20000,0,20000
"Paul, Rand",(R),Pikeville Medical Center,19500,0,19500
"Paul, Rand",(R),Toyota Motor North America,19500,19500,0
"Paul, Rand",(R),Impala Asset Management,18600,0,18600
"Paul, Rand",(R),Verizon Communications,18525,18000,525
"Paul, Rand",(R),Duke & Duke,18300,0,18300
"Paul, Rand",(R),Carlyle Group,18225,0,18225
"Paul, Rand",(R),FMR Corp,18000,18000,0
"Paul, Rand",(R),Research Affiliates LLC,17500,0,17500
"Paul, Rand",(R),Manchester Financial Group,17200,0,17200
"Paul, Rand",(R),Xlp Corp,16900,0,16900
"Paul, Rand",(R),Eb5 Investors Magazine,16790,0,16790
"Paul, Rand",(R),McKinley Assoc,16600,0,16600
"Paul, Rand",(R),Latham & Watkins,16300,0,16300
"Paul, Rand",(R),AVG Advanced Technologies,15800,0,15800
"Paul, Rand",(R),Amazon.com,15700,2500,13200
"Paul, Rand",(R),Cory M Dean LLC,15600,0,15600
"Paul, Rand",(R),Downey & Cleveland,15600,0,15600
"Paul, Rand",(R),Um Holdings,15600,0,15600
"Paul, Rand",(R),Founders Fund,15000,0,15000
"Paul, Rand",(R),Vi-Jon Laboratories,15000,0,15000
"Paul, Rand",(R),Charah Inc,14500,0,14500
"Paul, Rand",(R),DaVita Inc,14500,8000,6500
"Paul, Rand",(R),Chelsea Management,14200,0,14200
"Paul, Rand",(R),ICI Homes,14000,0,14000
"Paul, Rand",(R),Chandler Management,13700,0,13700
"Paul, Rand",(R),Papercone Corp,13600,0,13600
"Paul, Rand",(R),Scott & Ritter,13400,0,13400
"Paul, Rand",(R),RB Murphy & Assoc,13300,0,13300
"Paul, Rand",(R),Picoco LLC,13200,0,13200
"Paul, Rand",(R),Bukowsky Law Firm,13100,0,13100
"Paul, Rand",(R),Centerview Partners,13100,0,13100
"Paul, Rand",(R),Agentis Management,13025,0,13025
"Paul, Rand",(R),Northwestern Mutual,12950,5000,7950
"Paul, Rand",(R),Ingalls & Snyder,12900,0,12900
"Paul, Rand",(R),University of Kentucky,12805,0,12805
"Paul, Rand",(R),Deason Capital Services,12800,0,12800
"Paul, Rand",(R),Tennessee Industrial Electronics,12800,0,12800
"Paul, Rand",(R),Marquette Transportation,12620,0,12620
"Paul, Rand",(R),Young Americans for Liberty,12620,12420,200
"Paul, Rand",(R),Charter Communications,12500,12500,0
"Paul, Rand",(R),Deloitte LLP,12500,12500,0
"Paul, Rand",(R),Humana Inc,12451,10000,2451
"Paul, Rand",(R),Zuma Capital,12275,0,12275
"Paul, Rand",(R),Pfizer Inc,12210,11000,1210
"Paul, Rand",(R),American Academy of Ophthalmology,12000,12000,0
"Paul, Rand",(R),National Pro-Life Alliance,12000,12000,0
"Paul, Rand",(R),Analytical Systems International,11900,0,11900
"Paul, Rand",(R),Wcfs Inc,11200,0,11200
"Paul, Rand",(R),National Beer Wholesalers Assn,11000,11000,0
"Paul, Rand",(R),Overstock.Com,10800,0,10800
"Paul, Rand",(R),Worldly Cfo,10800,0,10800
"Paul, Rand",(R),Rare Antibody Antigen Supply,10600,0,10600
"Paul, Rand",(R),Wall Street Journal,10600,0,10600
"Paul, Rand",(R),Westgate Resorts Ltd,10600,0,10600
"Paul, Rand",(R),Avenue Ventures,10400,0,10400
"Peters, Gary",(D),University of Michigan,594732,0,594732
"Peters, Gary",(D),Alphabet Inc,255498,25000,230498
"Peters, Gary",(D),University of California,180369,0,180369
"Peters, Gary",(D),Michigan State University,163007,0,163007
"Peters, Gary",(D),Goldman Sachs,160635,40000,120635
"Peters, Gary",(D),General Dynamics,142534,37000,105534
"Peters, Gary",(D),General Motors,134446,40000,94446
"Peters, Gary",(D),Microsoft Corp,130781,24500,106281
"Peters, Gary",(D),Ford Motor Co,129674,40000,89674
"Peters, Gary",(D),Henry Ford Health System,118828,10000,108828
"Peters, Gary",(D),State of Michigan,116146,0,116146
"Peters, Gary",(D),Democracy Engine,111192,0,111192
"Peters, Gary",(D),Blue Cross/Blue Shield,103083,19000,84083
"Peters, Gary",(D),Amazon.com,95458,15000,80458
"Peters, Gary",(D),Walt Disney Co,93525,8000,85525
"Peters, Gary",(D),Capital Group Companies,88463,20000,68463
"Peters, Gary",(D),Apple Inc,86693,0,86693
"Peters, Gary",(D),Blackstone Group,84915,0,84915
"Peters, Gary",(D),Wayne State University,84405,0,84405
"Peters, Gary",(D),Comcast Corp,83424,40000,43424
"Peters, Gary",(D),CMS Energy,81350,35000,46350
"Peters, Gary",(D),JPMorgan Chase & Co,80164,35000,45164
"Peters, Gary",(D),DTE Energy,79323,40000,39323
"Peters, Gary",(D),American Airlines Group,75664,21000,54664
"Peters, Gary",(D),Facebook Inc,74902,12500,62402
"Peters, Gary",(D),Charter Communications,69799,40000,29799
"Peters, Gary",(D),AT&T Inc,67597,20000,47597
"Peters, Gary",(D),US Government,67212,0,67212
"Peters, Gary",(D),Form G Tech,62500,0,62500
"Peters, Gary",(D),Delta Air Lines,61517,30000,31517
"Peters, Gary",(D),Harvard University,61054,0,61054
"Peters, Gary",(D),Visa Inc,59780,32000,27780
"Peters, Gary",(D),Berkshire Hathaway,58045,28000,30045
"Peters, Gary",(D),Cisco Systems,57911,11000,46911
"Peters, Gary",(D),Deloitte LLP,57523,40000,17523
"Peters, Gary",(D),Jackson National Life Insurance,55545,25000,30545
"Peters, Gary",(D),IBM Corp,54419,0,54419
"Peters, Gary",(D),Stanford University,53573,0,53573
"Peters, Gary",(D),Dow Inc,53447,17500,35947
"Peters, Gary",(D),America's Credit Unions,50933,44500,6433
"Peters, Gary",(D),Pfizer Inc,50220,35000,15220
"Peters, Gary",(D),PricewaterhouseCoopers,49613,35000,14613
"Peters, Gary",(D),UBS AG,48533,40000,8533
"Peters, Gary",(D),KPMG LLP,48525,40000,8525
"Peters, Gary",(D),WilmerHale Llp,48428,0,48428
"Peters, Gary",(D),Ernst & Young,47170,25000,22170
"Peters, Gary",(D),"Paul, Weiss et al",45224,0,45224
"Peters, Gary",(D),Corewell Health,45034,0,45034
"Peters, Gary",(D),Northrop Grumman,41744,37000,4744
"Peters, Gary",(D),Honeywell International,41206,37500,3706
"Peters, Gary",(D),National Multifamily Housing Council,40500,40000,500
"Peters, Gary",(D),Air Line Pilots Assn,40224,40000,224
"Peters, Gary",(D),Council of Insurance Agents & Brokers,40000,40000,0
"Peters, Gary",(D),International Brotherhood of Electrical Workers,39905,35000,4905
"Peters, Gary",(D),Verizon Communications,39868,22000,17868
"Peters, Gary",(D),Kaiser Permanente,39426,0,39426
"Peters, Gary",(D),State of California,39182,0,39182
"Peters, Gary",(D),American Institute of CPAs,38500,38500,0
"Peters, Gary",(D),Bank of America,38263,20000,18263
"Peters, Gary",(D),Western Michigan University,38189,0,38189
"Peters, Gary",(D),Renaissance Technologies,38103,0,38103
"Peters, Gary",(D),Kirkland & Ellis,37977,0,37977
"Peters, Gary",(D),"City of New York, NY",37778,0,37778
"Peters, Gary",(D),Oracle Corp,37650,1000,36650
"Peters, Gary",(D),American Hospital Assn,37318,25999,11319
"Peters, Gary",(D),New York Life Insurance,37256,35000,2256
"Peters, Gary",(D),Centene Corp,37100,10000,27100
"Peters, Gary",(D),DE Shaw & Co,37030,0,37030
"Peters, Gary",(D),Intel Corp,36898,15500,21398
"Peters, Gary",(D),FedEx Corp,36721,33000,3721
"Peters, Gary",(D),Mortgage Bankers Assn,36501,36000,501
"Peters, Gary",(D),Columbia University,35960,0,35960
"Peters, Gary",(D),Wells Fargo,35807,15000,20807
"Peters, Gary",(D),Home Depot,35428,27500,7928
"Peters, Gary",(D),Investment Co Institute,35000,35000,0
"Peters, Gary",(D),United Parcel Service,33851,30000,3851
"Peters, Gary",(D),American Bankers Assn,33842,31000,2842
"Peters, Gary",(D),Honigman LLP,33738,0,33738
"Peters, Gary",(D),Cox Enterprises,33676,11000,22676
"Peters, Gary",(D),Match-E-Be-Nash-She-Wish Band Pottawatomi Indians,33400,0,33400
"Peters, Gary",(D),Raytheon Technologies,33264,20000,13264
"Peters, Gary",(D),UnitedHealth Group,33163,21000,12163
"Peters, Gary",(D),Abbott Laboratories,32928,30000,2928
"Peters, Gary",(D),Humana Inc,32646,30000,2646
"Peters, Gary",(D),Poet LLC,32508,27500,5008
"Peters, Gary",(D),US Dept of Veterans Affairs,32159,0,32159
"Peters, Gary",(D),Route One Investment,31800,0,31800
"Peters, Gary",(D),Rock Holdings,31795,25000,6795
"Peters, Gary",(D),Merck & Co,31349,24000,7349
"Peters, Gary",(D),Massachusetts Mutual Life Insurance,31347,20000,11347
"Peters, Gary",(D),Morgan Stanley,31219,10000,21219
"Peters, Gary",(D),Dykema Gossett,31194,19000,12194
"Peters, Gary",(D),Central Michigan University,31162,0,31162
"Peters, Gary",(D),Boeing Co,30853,17500,13353
"Peters, Gary",(D),National Assn of Broadcasters,30788,25000,5788
"Peters, Gary",(D),Motley Rice LLC,30592,0,30592
"Peters, Gary",(D),New York University,30488,0,30488
"Peters, Gary",(D),VoteVets.org,30012,30000,12
"Peters, Gary",(D),National Beer Wholesalers Assn,30000,30000,0
"Peters, Gary",(D),Greenberg Traurig LLP,29908,9999,19909
"Portman, Rob",(R),Goldman Sachs,177975,22000,155975
"Portman, Rob",(R),American Financial Group,126700,0,126700
"Portman, Rob",(R),Votesane PAC,123900,0,123900
"Portman, Rob",(R),Marathon Petroleum,119245,45000,74245
"Portman, Rob",(R),Capital Group Companies,114700,26500,88200
"Portman, Rob",(R),Fidelity Investments,97900,36500,61400
"Portman, Rob",(R),Procter & Gamble,95285,9500,85785
"Portman, Rob",(R),JPMorgan Chase & Co,92830,14000,78830
"Portman, Rob",(R),General Electric,88750,19000,69750
"Portman, Rob",(R),Home Depot,87824,35000,52824
"Portman, Rob",(R),Nationwide,87320,42000,45320
"Portman, Rob",(R),BlackRock Inc,78375,19000,59375
"Portman, Rob",(R),Cardinal Health,78365,35000,43365
"Portman, Rob",(R),MetLife Inc,76600,28000,48600
"Portman, Rob",(R),Blackstone Group,75125,2500,72625
"Portman, Rob",(R),Sullivan & Cromwell,71850,0,71850
"Portman, Rob",(R),Pfizer Inc,64500,33000,31500
"Portman, Rob",(R),Blue Cross/Blue Shield,64010,59000,5010
"Portman, Rob",(R),Verizon Communications,63600,35000,28600
"Portman, Rob",(R),MacAndrews & Forbes,62557,29557,33000
"Portman, Rob",(R),Berkshire Hathaway,62550,35200,27350
"Portman, Rob",(R),Deloitte LLP,62410,39000,23410
"Portman, Rob",(R),Apple Inc,61010,0,61010
"Portman, Rob",(R),Ernst & Young,60550,9500,51050
"Portman, Rob",(R),Ford Motor Co,58650,34000,24650
"Portman, Rob",(R),Exelon Corp,58450,45000,13450
"Portman, Rob",(R),FedEx Corp,54920,36000,18920
"Portman, Rob",(R),General Dynamics,53815,44500,9315
"Portman, Rob",(R),Cleveland-Cliffs,53650,42000,11650
"Portman, Rob",(R),RTX Corp,52410,41000,11410
"Portman, Rob",(R),General Motors,51120,40000,11120
"Portman, Rob",(R),Standard Textile,51098,0,51098
"Portman, Rob",(R),CVS Health,50850,40000,10850
"Portman, Rob",(R),Eli Lilly & Co,50600,23000,27600
"Portman, Rob",(R),Huntington Bancshares,50100,41000,9100
"Portman, Rob",(R),Hunt Development,49800,0,49800
"Portman, Rob",(R),Frost Brown Todd Llc,49735,0,49735
"Portman, Rob",(R),Joseph Auto Group,48900,0,48900
"Portman, Rob",(R),Fifth Third Bancorp,47900,9000,38900
"Portman, Rob",(R),Travelers Companies,47500,33000,14500
"Portman, Rob",(R),UnitedHealth Group,47200,37500,9700
"Portman, Rob",(R),Morgan Stanley,47075,16000,31075
"Portman, Rob",(R),Cisco Systems,46975,12500,34475
"Portman, Rob",(R),National Republican Senatorial Cmte,46800,46800,0
"Portman, Rob",(R),Abbott Laboratories,46400,39500,6900
"Portman, Rob",(R),Squire Patton Boggs,45350,16000,29350
"Portman, Rob",(R),"Welsh, Carson et al",45000,0,45000
"Portman, Rob",(R),Rpm International,44400,5000,39400
"Portman, Rob",(R),Northwestern Mutual,44300,24000,20300
"Portman, Rob",(R),Clearpath Foundation,44200,0,44200
"Portman, Rob",(R),USAA,44000,25000,19000
"Portman, Rob",(R),AT&T Inc,43955,38500,5455
"Portman, Rob",(R),Amgen Inc,43950,28500,15450
"Portman, Rob",(R),Cox Enterprises,43750,28000,15750
"Portman, Rob",(R),Elliott Management,43700,0,43700
"Portman, Rob",(R),Air Line Pilots Assn,43500,43500,0
"Portman, Rob",(R),North American Properties,43433,0,43433
"Portman, Rob",(R),Timken Co,43355,7500,35855
"Portman, Rob",(R),Google Inc,43200,27500,15700
"Portman, Rob",(R),NextEra Energy,43000,34000,9000
"Portman, Rob",(R),Duke Energy,42900,31500,11400
"Portman, Rob",(R),River Trading,42900,0,42900
"Portman, Rob",(R),International Paper,42510,38000,4510
"Portman, Rob",(R),MasterCard Inc,42200,10000,32200
"Portman, Rob",(R),CSX Corp,42005,29500,12505
"Portman, Rob",(R),NVR Inc,42000,0,42000
"Portman, Rob",(R),Pinnacle West Capital,41800,31000,10800
"Portman, Rob",(R),PricewaterhouseCoopers,41800,25500,16300
"Portman, Rob",(R),United Parcel Service,41755,37000,4755
"Portman, Rob",(R),Bechtel Group,41700,10000,31700
"Portman, Rob",(R),Prudential Financial,41600,17500,24100
"Portman, Rob",(R),State Street Corp,41500,11500,30000
"Portman, Rob",(R),Leach Capital,41000,0,41000
"Portman, Rob",(R),"Calfee, Halter & Griswold",40600,2750,37850
"Portman, Rob",(R),Whirlpool Corp,40415,21000,19415
"Portman, Rob",(R),Bank of America,40250,10000,30250
"Portman, Rob",(R),Comcast Corp,40100,38000,2100
"Portman, Rob",(R),Automotive Free International Trade PAC,40000,40000,0
"Portman, Rob",(R),Honeywell International,40000,35000,5000
"Portman, Rob",(R),National Multifamily Housing Council,40000,40000,0
"Portman, Rob",(R),Sherwin-Williams Co,39903,0,39903
"Portman, Rob",(R),National Assn of Realtors,39500,39000,500
"Portman, Rob",(R),Union Pacific Corp,39500,36000,3500
"Portman, Rob",(R),Hewlett Packard Enterprise,39000,39000,0
"Portman, Rob",(R),"Keating, Muething & Klekamp",38800,5000,33800
"Portman, Rob",(R),Carlyle Group,38400,0,38400
"Portman, Rob",(R),L Brands,38050,10000,28050
"Portman, Rob",(R),Wells Fargo,37935,12500,25435
"Portman, Rob",(R),Southern Co,37525,37500,25
"Portman, Rob",(R),AFLAC Inc,37500,37500,0
"Portman, Rob",(R),Eastman Chemical,37500,37500,0
"Portman, Rob",(R),National Assn of Real Estate Investment Trusts,37500,37500,0
"Portman, Rob",(R),"Akin, Gump et al",37460,12500,24960
"Portman, Rob",(R),alliantgroup,36900,0,36900
"Portman, Rob",(R),Dominion Energy,36500,34000,2500
"Portman, Rob",(R),Urology Group,36400,0,36400
"Portman, Rob",(R),Northrop Grumman,36290,33500,2790
"Portman, Rob",(R),National Rural Electric Cooperative Assn,36000,36000,0
"Portman, Rob",(R),"Vorys, Sater et al",35975,7000,28975
"Portman, Rob",(R),Jones Day,35224,0,35224
"Reed, Jack",(D),General Dynamics,133875,40000,93875
"Reed, Jack",(D),Lockheed Martin,95300,40000,55300
"Reed, Jack",(D),L3Harris Technologies,68625,29000,39625
"Reed, Jack",(D),RTX Corp,53750,46500,7250
"Reed, Jack",(D),CVS Health,46000,40000,6000
"Reed, Jack",(D),Northrop Grumman,43250,40500,2750
"Reed, Jack",(D),Amgen Inc,42800,40000,2800
"Reed, Jack",(D),General Atomics,41150,27500,13650
"Reed, Jack",(D),Boeing Co,40051,40000,51
"Reed, Jack",(D),BAE Systems,40001,40000,1
"Reed, Jack",(D),Honeywell International,40000,40000,0
"Reed, Jack",(D),Huntington Ingalls Industries,40000,40000,0
"Reed, Jack",(D),Mortgage Bankers Assn,40000,40000,0
"Reed, Jack",(D),National Assn of Realtors,40000,40000,0
"Reed, Jack",(D),National Multifamily Housing Council,40000,40000,0
"Reed, Jack",(D),Norfolk Southern,40000,40000,0
"Reed, Jack",(D),UBS Americas,40000,40000,0
"Reed, Jack",(D),SAIC,37025,36500,525
"Reed, Jack",(D),National Air Traffic Controllers Assn,37000,37000,0
"Reed, Jack",(D),Aloha Partners,34100,0,34100
"Reed, Jack",(D),Leidos Inc,34000,32500,1500
"Reed, Jack",(D),Textron Inc,31000,27500,3500
"Reed, Jack",(D),Berkshire Hathaway,30006,30000,6
"Reed, Jack",(D),DynCorp International,29000,29000,0
"Reed, Jack",(D),International Brotherhood of Electrical Workers,28500,28500,0
"Reed, Jack",(D),Walt Disney Co,28491,5000,23491
"Reed, Jack",(D),Comcast Corp,27601,21000,6601
"Reed, Jack",(D),America's Credit Unions,26000,26000,0
"Reed, Jack",(D),General Motors,26000,26000,0
"Reed, Jack",(D),Laborers Union,25350,25000,350
"Reed, Jack",(D),American Academy of Dermatology Assn,25000,25000,0
"Reed, Jack",(D),National Assn of Real Estate Investment Trusts,25000,25000,0
"Reed, Jack",(D),Operating Engineers Union,25000,25000,0
"Reed, Jack",(D),Union Pacific Corp,25000,25000,0
"Reed, Jack",(D),Citizens Financial Group,24063,13500,10563
"Reed, Jack",(D),Bank of America,23795,22000,1795
"Reed, Jack",(D),Sierra Nevada Corp,22500,13500,9000
"Reed, Jack",(D),Holland & Knight,21500,20000,1500
"Reed, Jack",(D),Raytheon Technologies,20710,17000,3710
"Reed, Jack",(D),Dimeo Construction,20550,0,20550
"Reed, Jack",(D),Dahlberg Strategic,20500,0,20500
"Reed, Jack",(D),Amazon.com,20000,20000,0
"Reed, Jack",(D),Century 21 Department Stores,20000,0,20000
"Reed, Jack",(D),CSX Corp,20000,20000,0
"Reed, Jack",(D),Punaro Group,18800,0,18800
"Reed, Jack",(D),SpaceX,18800,16000,2800
"Reed, Jack",(D),Cox Enterprises,18500,18500,0
"Reed, Jack",(D),Deloitte LLP,17503,17500,3
"Reed, Jack",(D),International Assn of Fire Fighters,17500,17500,0
"Reed, Jack",(D),National Apartment Assn,17500,17500,0
"Reed, Jack",(D),National Assn of Home Builders,17500,17500,0
"Reed, Jack",(D),Service Employees International Union,17500,10000,7500
"Reed, Jack",(D),United Launch Alliance,17100,0,17100
"Reed, Jack",(D),Fluor Corp,17000,17000,0
"Reed, Jack",(D),American College of Emergency Physicians,16500,16500,0
"Reed, Jack",(D),Leonardo DRS,16500,16500,0
"Reed, Jack",(D),Greenberg Traurig LLP,16400,5000,11400
"Reed, Jack",(D),Motorola Solutions,16000,16000,0
"Reed, Jack",(D),AFLAC Inc,15600,10000,5600
"Reed, Jack",(D),AT&T Inc,15507,15500,7
"Reed, Jack",(D),American Federation of Government Employees,15500,15500,0
"Reed, Jack",(D),Amalgamated Transit Union,15000,15000,0
"Reed, Jack",(D),Home Depot,15000,15000,0
"Reed, Jack",(D),Ironworkers Union,15000,15000,0
"Reed, Jack",(D),National Assn of Letter Carriers,15000,15000,0
"Reed, Jack",(D),National Beer Wholesalers Assn,15000,15000,0
"Reed, Jack",(D),Transport Workers Union,15000,15000,0
"Reed, Jack",(D),USAA,15000,15000,0
"Reed, Jack",(D),Bricklayers Union,14500,14500,0
"Reed, Jack",(D),Council of Insurance Agents & Brokers,14500,14500,0
"Reed, Jack",(D),"Kramer, Levin et al",14000,0,14000
"Reed, Jack",(D),New York Life Insurance,14000,14000,0
"Reed, Jack",(D),Venable LLP,13750,2500,11250
"Reed, Jack",(D),Microsoft Corp,13600,13500,100
"Reed, Jack",(D),Air Line Pilots Assn,13500,13500,0
"Reed, Jack",(D),Painters & Allied Trades Union,13500,13500,0
"Reed, Jack",(D),Arnold & Porter Kaye Scholer,12750,5000,7750
"Reed, Jack",(D),JPMorgan Chase & Co,12600,7000,5600
"Reed, Jack",(D),Massachusetts Mutual Life Insurance,12500,12500,0
"Reed, Jack",(D),Real Estate Roundtable,12500,12500,0
"Reed, Jack",(D),VoteVets.org,12500,12500,0
"Reed, Jack",(D),AECOM Global,12000,7500,4500
"Reed, Jack",(D),American Property Casualty Insurance Assn,12000,12000,0
"Reed, Jack",(D),American Seniors Housing Assn,12000,12000,0
"Reed, Jack",(D),Oshkosh Corp,11568,10000,1568
"Reed, Jack",(D),BWX Technologies,11500,11500,0
"Reed, Jack",(D),National Education Assn,11500,10000,1500
"Reed, Jack",(D),Public Strategies Washington,11500,0,11500
"Reed, Jack",(D),Amica Mutual Insurance,11300,10800,500
"Reed, Jack",(D),Cumberland Farms,11300,10300,1000
"Reed, Jack",(D),Belvoir Properties,11200,0,11200
"Reed, Jack",(D),Democracy Engine,11200,0,11200
"Reed, Jack",(D),Lyft Inc,11200,0,11200
"Reed, Jack",(D),Teamsters Union,11010,10000,1010
"Reed, Jack",(D),Cubic Corp,11000,11000,0
"Reed, Jack",(D),Depository Trust & Clearing Corp,11000,11000,0
"Reed, Jack",(D),Innovative Defense Technologies,11000,0,11000
"Reed, Jack",(D),Investment Co Institute,11000,11000,0
"Reed, Jack",(D),Kratos Defense & Security Solutions,11000,10000,1000
"Reed, Jack",(D),Apollo Global Management,10900,0,10900
"Risch, James E",(R),Delta Air Lines,49225,25000,24225
"Risch, James E",(R),Hewlett Packard Enterprise,46500,40000,6500
"Risch, James E",(R),General Atomics,43600,23000,20600
"Risch, James E",(R),Lockheed Martin,35055,35000,55
"Risch, James E",(R),Berkshire Hathaway,35000,35000,0
"Risch, James E",(R),National Republican Senatorial Cmte,35000,35000,0
"Risch, James E",(R),Sinclair Companies,34700,0,34700
"Risch, James E",(R),Southern Co,30015,30000,15
"Risch, James E",(R),Northrop Grumman,25005,25000,5
"Risch, James E",(R),Apollo Global Management,24400,0,24400
"Risch, James E",(R),Home Depot,22510,22500,10
"Risch, James E",(R),Union Pacific Corp,22500,22500,0
"Risch, James E",(R),General Dynamics,20025,20000,25
"Risch, James E",(R),Comcast Corp,20000,20000,0
"Risch, James E",(R),Koch Inc,20000,20000,0
"Risch, James E",(R),Koch Industries,20000,20000,0
"Risch, James E",(R),Micron Technology,20000,20000,0
"Risch, James E",(R),Raytheon Co,20000,20000,0
"Risch, James E",(R),Kayla's List,19300,19300,0
"Risch, James E",(R),Google Inc,19000,19000,0
"Risch, James E",(R),FedEx Corp,18250,18000,250
"Risch, James E",(R),Goldman Sachs,17900,0,17900
"Risch, James E",(R),Honeywell International,17600,17500,100
"Risch, James E",(R),Seacoast Commerce Bank,17600,0,17600
"Risch, James E",(R),Idaho Power,17000,15000,2000
"Risch, James E",(R),Pinnacle West Capital,17000,17000,0
"Risch, James E",(R),Hunt Consolidated,16800,0,16800
"Risch, James E",(R),Idaho Forest Group,16800,0,16800
"Risch, James E",(R),Capital Group Companies,16500,0,16500
"Risch, James E",(R),Intel Corp,16025,16000,25
"Risch, James E",(R),PotlatchDeltic Corp,16000,9000,7000
"Risch, James E",(R),1st Financial Bank USA,15800,0,15800
"Risch, James E",(R),Chevron Corp,15505,15500,5
"Risch, James E",(R),Deloitte LLP,15025,15000,25
"Risch, James E",(R),BGR Group,14000,0,14000
"Risch, James E",(R),Bridgewater Assoc,14000,0,14000
"Risch, James E",(R),BWX Technologies,13500,13500,0
"Risch, James E",(R),Visa Inc,13500,13500,0
"Risch, James E",(R),Raytheon Technologies,13000,13000,0
"Risch, James E",(R),Boeing Co,12600,12500,100
"Risch, James E",(R),Wolfson Group,12600,0,12600
"Risch, James E",(R),American Bankers Assn,12525,12500,25
"Risch, James E",(R),American Institute of CPAs,12500,12500,0
"Risch, James E",(R),Edison Electric Institute,12500,10500,2000
"Risch, James E",(R),Enterprise Holdings,12500,12500,0
"Risch, James E",(R),Marathon Petroleum,12500,12500,0
"Risch, James E",(R),National Assn of Home Builders,12500,12500,0
"Risch, James E",(R),National Beer Wholesalers Assn,12500,12500,0
"Risch, James E",(R),Small Business Investor Alliance,12500,12500,0
"Risch, James E",(R),AVG Advanced Technologies,11200,0,11200
"Risch, James E",(R),Blackstone Group,11200,0,11200
"Risch, James E",(R),Blue Cross/Blue Shield,11000,9000,2000
"Risch, James E",(R),Credit Union National Assn,11000,11000,0
"Risch, James E",(R),Microsoft Corp,11000,11000,0
"Risch, James E",(R),National Assn of Real Estate Investment Trusts,11000,11000,0
"Risch, James E",(R),National Assn of Realtors,11000,11000,0
"Risch, James E",(R),Vista Outdoor,11000,11000,0
"Risch, James E",(R),Civic Service Inc,10600,0,10600
"Risch, James E",(R),Citigroup Inc,10500,10500,0
"Risch, James E",(R),Independent Community Bankers of America,10500,10500,0
"Risch, James E",(R),National Air Traffic Controllers Assn,10500,10500,0
"Risch, James E",(R),Exxon Mobil,10002,10000,2
"Risch, James E",(R),21st Century Majority Fund,10000,10000,0
"Risch, James E",(R),Alamo PAC,10000,10000,0
"Risch, James E",(R),American Crystal Sugar,10000,10000,0
"Risch, James E",(R),Automotive Free International Trade PAC,10000,10000,0
"Risch, James E",(R),Bluegrass Cmte,10000,10000,0
"Risch, James E",(R),Common Values PAC,10000,10000,0
"Risch, James E",(R),Covington & Burling,10000,10000,0
"Risch, James E",(R),Defend America PAC,10000,10000,0
"Risch, James E",(R),Denali Leadership PAC,10000,10000,0
"Risch, James E",(R),Dirigo PAC,10000,10000,0
"Risch, James E",(R),Ernst & Young,10000,10000,0
"Risch, James E",(R),Freedom Fund,10000,10000,0
"Risch, James E",(R),Fund for a Conservative Future,10000,10000,0
"Risch, James E",(R),Fund for America's Future,10000,10000,0
"Risch, James E",(R),Halliburton Co,10000,10000,0
"Risch, James E",(R),Heartland Values PAC,10000,10000,0
"Risch, James E",(R),Hoosier PAC (Braun),10000,10000,0
"Risch, James E",(R),"Jobs, Opportunity & New Ideas PAC",10000,10000,0
"Risch, James E",(R),MARSHA PAC,10000,10000,0
"Risch, James E",(R),National Auto Dealers Assn,10000,10000,0
"Risch, James E",(R),Nebraska Sandhills PAC,10000,10000,0
"Risch, James E",(R),Next Century Fund,10000,10000,0
"Risch, James E",(R),One Georgia PAC,10000,10000,0
"Risch, James E",(R),Oorah! PAC,10000,10000,0
"Risch, James E",(R),Pelican PAC,10000,10000,0
"Risch, James E",(R),Project West PAC,10000,10000,0
"Risch, James E",(R),Reclaim America PAC,10000,10000,0
"Risch, James E",(R),Rely on Your Beliefs,10000,10000,0
"Risch, James E",(R),Republican Jewish Coalition,10000,10000,0
"Risch, James E",(R),Republican Majority Fund,10000,10000,0
"Risch, James E",(R),Responsibility & Freedom Work PAC,10000,10000,0
"Risch, James E",(R),Senate Victory Fund,10000,10000,0
"Risch, James E",(R),Tomorrow Is Meaningful,10000,10000,0
"Risch, James E",(R),True North PAC,10000,10000,0
"Risch, James E",(R),UBS Americas,10000,10000,0
"Risch, James E",(R),American Lighting Assn,9998,9998,0
"Risch, James E",(R),National Shooting Sports Foundation,9500,9500,0
"Risch, James E",(R),HP Inc,9050,9000,50
"Romney, Mitt",(R),Bain Capital,120300,0,120300
"Romney, Mitt",(R),Blackstone Group,73200,0,73200
"Romney, Mitt",(R),Gardner Co,53600,0,53600
"Romney, Mitt",(R),Sinclair Companies,40500,0,40500
"Romney, Mitt",(R),Fidelity Investments,39650,15000,24650
"Romney, Mitt",(R),AQR Capital Management,38800,0,38800
"Romney, Mitt",(R),Credit Suisse Group,37100,0,37100
"Romney, Mitt",(R),Goldman Sachs,34550,5000,29550
"Romney, Mitt",(R),Dominion Energy,31000,15000,16000
"Romney, Mitt",(R),Zions Bancorp,29850,5000,24850
"Romney, Mitt",(R),Sotheby's,29300,0,29300
"Romney, Mitt",(R),Summit Partners,27000,0,27000
"Romney, Mitt",(R),Northern Virginia Technology Council,25400,0,25400
"Romney, Mitt",(R),Huntsman Corp,24300,0,24300
"Romney, Mitt",(R),Sun Capital Partners,24300,0,24300
"Romney, Mitt",(R),TPG Capital,24300,0,24300
"Romney, Mitt",(R),Marriott International,23700,5000,18700
"Romney, Mitt",(R),Tiger Management,23700,0,23700
"Romney, Mitt",(R),Tudor Investment,23200,0,23200
"Romney, Mitt",(R),4Life Research,21200,0,21200
"Romney, Mitt",(R),Keller Investment Properties,21200,0,21200
"Romney, Mitt",(R),First Atlantic Capital,20800,0,20800
"Romney, Mitt",(R),L3Harris Technologies,20135,20000,135
"Romney, Mitt",(R),SCF Partners,19700,0,19700
"Romney, Mitt",(R),Capital Group Companies,19100,10000,9100
"Romney, Mitt",(R),Maverick Capital,18600,0,18600
"Romney, Mitt",(R),Hexagon Properties,18500,0,18500
"Romney, Mitt",(R),McCarthy Hennings Whalen,18375,0,18375
"Romney, Mitt",(R),Lionsheart,18100,0,18100
"Romney, Mitt",(R),Intermountain Health Care,16500,0,16500
"Romney, Mitt",(R),Acosta Sales & Marketing,16200,0,16200
"Romney, Mitt",(R),Belkin International,16200,0,16200
"Romney, Mitt",(R),Brady Industries,16200,0,16200
"Romney, Mitt",(R),CR England Inc,16200,0,16200
"Romney, Mitt",(R),Harbour Group Industries,16200,0,16200
"Romney, Mitt",(R),Larry H Miller Group,16200,0,16200
"Romney, Mitt",(R),MRIoA,16200,0,16200
"Romney, Mitt",(R),Nierenberg Investment Management,16200,0,16200
"Romney, Mitt",(R),Stewart & Stevenson,16200,0,16200
"Romney, Mitt",(R),Thackeray Co,16200,0,16200
"Romney, Mitt",(R),"Welsh, Carson et al",16200,0,16200
"Romney, Mitt",(R),WSJ Properties,16200,0,16200
"Romney, Mitt",(R),Fresenius Medical Care,15400,15000,400
"Romney, Mitt",(R),Microsoft Corp,15145,15000,145
"Romney, Mitt",(R),Delta Air Lines,15100,15000,100
"Romney, Mitt",(R),Comcast Corp,15020,15000,20
"Romney, Mitt",(R),Blue Cross/Blue Shield,15010,15000,10
"Romney, Mitt",(R),Federation of American Hospitals,15000,15000,0
"Romney, Mitt",(R),Hanover Co,15000,0,15000
"Romney, Mitt",(R),LifePoint Health,15000,15000,0
"Romney, Mitt",(R),Mortgage Bankers Assn,15000,15000,0
"Romney, Mitt",(R),Crow Holdings,13500,0,13500
"Romney, Mitt",(R),Extra Space Storage,13500,0,13500
"Romney, Mitt",(R),Haebler Capital,13500,0,13500
"Romney, Mitt",(R),Thomas H Lee Partners,13500,0,13500
"Romney, Mitt",(R),Dentons,13310,2500,10810
"Romney, Mitt",(R),GCP Capital Partners,13200,0,13200
"Romney, Mitt",(R),CC Industries,13100,0,13100
"Romney, Mitt",(R),Martin Selig Real Estate,13100,0,13100
"Romney, Mitt",(R),Hudson Institute,12850,0,12850
"Romney, Mitt",(R),Northrop Grumman,12825,10000,2825
"Romney, Mitt",(R),TigerRisk Partners,12700,0,12700
"Romney, Mitt",(R),PricewaterhouseCoopers,11700,0,11700
"Romney, Mitt",(R),Related Companies,11600,0,11600
"Romney, Mitt",(R),Maggie Sottero Designs,11400,0,11400
"Romney, Mitt",(R),FedEx Corp,11200,8500,2700
"Romney, Mitt",(R),Harvard University,10890,0,10890
"Romney, Mitt",(R),Alticor Inc,10800,0,10800
"Romney, Mitt",(R),Axiom International Investors,10800,0,10800
"Romney, Mitt",(R),Bluff Point Assoc,10800,0,10800
"Romney, Mitt",(R),Clarke Capital Partners,10800,0,10800
"Romney, Mitt",(R),Fayez Sarofim & Co,10800,0,10800
"Romney, Mitt",(R),"Goldberg, Lindsay & Co",10800,0,10800
"Romney, Mitt",(R),Hess Corp,10800,0,10800
"Romney, Mitt",(R),Marcus Partners,10800,0,10800
"Romney, Mitt",(R),Melaleuca Inc,10800,0,10800
"Romney, Mitt",(R),New Balance Athletics,10800,0,10800
"Romney, Mitt",(R),Patterson Companies,10800,0,10800
"Romney, Mitt",(R),Station Casinos,10800,0,10800
"Romney, Mitt",(R),Suffolk Construction,10800,0,10800
"Romney, Mitt",(R),Traeger Grills,10800,0,10800
"Romney, Mitt",(R),Triple Creek Ranch,10800,0,10800
"Romney, Mitt",(R),Yancey Brothers,10800,0,10800
"Romney, Mitt",(R),Prime Policy Group,10700,2500,8200
"Romney, Mitt",(R),American Research Bureau,10600,0,10600
"Romney, Mitt",(R),FE Richardson & Co,10600,0,10600
"Romney, Mitt",(R),Idg Capital,10600,0,10600
"Romney, Mitt",(R),Kara Ross New York,10600,0,10600
"Romney, Mitt",(R),Columbia University,10525,0,10525
"Romney, Mitt",(R),Investors Leasing Corp,10400,0,10400
"Romney, Mitt",(R),Marcus G Faust PC,10400,0,10400
"Romney, Mitt",(R),Maximus Inc,10400,0,10400
"Romney, Mitt",(R),TA Assoc,10400,0,10400
"Romney, Mitt",(R),Berkshire Hathaway,10250,10000,250
"Romney, Mitt",(R),Medquest Pharmacy,10250,0,10250
"Romney, Mitt",(R),UBS Americas,10250,10000,250
"Romney, Mitt",(R),Thermo Fisher Scientific,10025,10000,25
"Romney, Mitt",(R),Abbott Laboratories,10000,10000,0
"Romney, Mitt",(R),American Express,10000,10000,0
"Romney, Mitt",(R),American Physical Therapy Assn,10000,10000,0
"Rosen, Jacky",(D),EMILY's List,604219,10000,594219
"Rosen, Jacky",(D),Democracy Engine,173339,0,173339
"Rosen, Jacky",(D),Alphabet Inc,172695,10000,162695
"Rosen, Jacky",(D),University of California,149615,0,149615
"Rosen, Jacky",(D),League of Conservation Voters,135906,12396,123510
"Rosen, Jacky",(D),JStreetPAC,88975,0,88975
"Rosen, Jacky",(D),AT&T Inc,78676,5000,73676
"Rosen, Jacky",(D),Womencount PAC,71971,45,71926
"Rosen, Jacky",(D),Harvard University,67313,0,67313
"Rosen, Jacky",(D),Stanford University,65872,0,65872
"Rosen, Jacky",(D),University of Nevada,65401,0,65401
"Rosen, Jacky",(D),DE Shaw & Co,64003,0,64003
"Rosen, Jacky",(D),Microsoft Corp,58364,10000,48364
"Rosen, Jacky",(D),Honeywell International,51783,11883,39900
"Rosen, Jacky",(D),Democratic Senatorial Campaign Cmte,47415,47400,15
"Rosen, Jacky",(D),Blue Cross/Blue Shield,44045,6250,37795
"Rosen, Jacky",(D),Arcata Assoc,42300,0,42300
"Rosen, Jacky",(D),Goldman Sachs,42156,10000,32156
"Rosen, Jacky",(D),Harvey & Leslie Wagner Foundation,42000,0,42000
"Rosen, Jacky",(D),Apple Inc,41862,0,41862
"Rosen, Jacky",(D),Facebook Inc,40780,4000,36780
"Rosen, Jacky",(D),Varian Medical Systems,38575,5000,33575
"Rosen, Jacky",(D),Motley Rice LLC,38300,0,38300
"Rosen, Jacky",(D),"Brownstein, Hyatt et al",36698,3000,33698
"Rosen, Jacky",(D),"Buchanan, Ingersoll & Rooney",36306,0,36306
"Rosen, Jacky",(D),Bend The Arc Jewish Action,36225,9999,26226
"Rosen, Jacky",(D),Amazon.com,35766,2500,33266
"Rosen, Jacky",(D),"Paul, Weiss et al",35204,0,35204
"Rosen, Jacky",(D),Senior Care Pharmacy Coalition,33500,15000,18500
"Rosen, Jacky",(D),"Pachulski, Stang et al",33350,0,33350
"Rosen, Jacky",(D),Sullivan & Cromwell,32290,0,32290
"Rosen, Jacky",(D),Walt Disney Co,31667,0,31667
"Rosen, Jacky",(D),Wilmerhale Llp,31357,0,31357
"Rosen, Jacky",(D),International Brotherhood of Electrical Workers,30514,30000,514
"Rosen, Jacky",(D),Capital Group Companies,30489,7500,22989
"Rosen, Jacky",(D),MGM Resorts International,30442,15000,15442
"Rosen, Jacky",(D),Massachusetts Institute of Technology,29725,0,29725
"Rosen, Jacky",(D),Top Rank Inc,28905,0,28905
"Rosen, Jacky",(D),US Government,27965,0,27965
"Rosen, Jacky",(D),Berkshire Hathaway,27370,21000,6370
"Rosen, Jacky",(D),McKinsey & Co,27043,0,27043
"Rosen, Jacky",(D),Bank of New York Mellon,27035,1000,26035
"Rosen, Jacky",(D),"Sheet Metal, Air, Rail & Transportation Union",27005,23000,4005
"Rosen, Jacky",(D),Bluestem Asset Management,27000,0,27000
"Rosen, Jacky",(D),"Akin, Gump et al",26986,750,26236
"Rosen, Jacky",(D),Rosen Partners,26600,0,26600
"Rosen, Jacky",(D),Heising-Simons Foundation,26350,0,26350
"Rosen, Jacky",(D),"Cohen, Milstein et al",26213,0,26213
"Rosen, Jacky",(D),American College of Obstetricians & Gynecologists,26000,16000,10000
"Rosen, Jacky",(D),Latham & Watkins,25851,0,25851
"Rosen, Jacky",(D),Cloobeck Companies,25800,0,25800
"Rosen, Jacky",(D),"Williams, Hart et al",25650,0,25650
"Rosen, Jacky",(D),Comcast Corp,25453,10000,15453
"Rosen, Jacky",(D),IBM Corp,24818,0,24818
"Rosen, Jacky",(D),Henry Crown & Co,24700,0,24700
"Rosen, Jacky",(D),New York University,24659,0,24659
"Rosen, Jacky",(D),Liberty Partners Group,24500,0,24500
"Rosen, Jacky",(D),Scott Foundation,24500,0,24500
"Rosen, Jacky",(D),Renaissance Technologies,24400,0,24400
"Rosen, Jacky",(D),Berkshire Group,24300,0,24300
"Rosen, Jacky",(D),Proctor Lane Investments,24300,0,24300
"Rosen, Jacky",(D),Silver Lake Partners,24165,7065,17100
"Rosen, Jacky",(D),Kaiser Permanente,23516,0,23516
"Rosen, Jacky",(D),Ropes & Gray,23432,0,23432
"Rosen, Jacky",(D),"City of New York, NY",22774,0,22774
"Rosen, Jacky",(D),314 Action Fund,22700,17000,5700
"Rosen, Jacky",(D),Hackman Capital Partners,22600,0,22600
"Rosen, Jacky",(D),City University of New York,22586,0,22586
"Rosen, Jacky",(D),Princeton University,22528,0,22528
"Rosen, Jacky",(D),Duchossois Group,22400,0,22400
"Rosen, Jacky",(D),State of California,22156,0,22156
"Rosen, Jacky",(D),Kirkland & Ellis,21853,0,21853
"Rosen, Jacky",(D),Columbia University,21652,0,21652
"Rosen, Jacky",(D),Patagonia Works,21276,0,21276
"Rosen, Jacky",(D),Omni New York,21200,0,21200
"Rosen, Jacky",(D),Centene Corp,20981,15000,5981
"Rosen, Jacky",(D),Planned Parenthood,20930,9999,10931
"Rosen, Jacky",(D),Covington Group,20800,0,20800
"Rosen, Jacky",(D),National Air Traffic Controllers Assn,20500,20500,0
"Rosen, Jacky",(D),Pfizer Inc,20167,12500,7667
"Rosen, Jacky",(D),Greater New York Hospital Assn,19850,0,19850
"Rosen, Jacky",(D),Cooney & Conway,19513,0,19513
"Rosen, Jacky",(D),Intel Corp,19481,10000,9481
"Rosen, Jacky",(D),Cushman & Wakefield,19450,0,19450
"Rosen, Jacky",(D),Carson Medical Group,19355,0,19355
"Rosen, Jacky",(D),Forbes Tate Partners,19225,0,19225
"Rosen, Jacky",(D),WPP plc,19104,1000,18104
"Rosen, Jacky",(D),Boston University,18958,0,18958
"Rosen, Jacky",(D),Insight Partners,18905,0,18905
"Rosen, Jacky",(D),Medley Partners,18900,0,18900
"Rosen, Jacky",(D),Rallye Motors,18900,0,18900
"Rosen, Jacky",(D),Avenue Solutions,18728,0,18728
"Rosen, Jacky",(D),Deloitte LLP,18678,10000,8678
"Rosen, Jacky",(D),National Amusements Inc,18505,0,18505
"Rosen, Jacky",(D),University of Washington,18366,0,18366
"Rosen, Jacky",(D),Tellurian Inc,18300,0,18300
"Rosen, Jacky",(D),Cisco Systems,18047,0,18047
"Rosen, Jacky",(D),Tiber Creek Group,17950,0,17950
"Rosen, Jacky",(D),Fetner Properties,17732,0,17732
"Rosen, Jacky",(D),"Lieff, Cabraser et al",17628,0,17628
"Rounds, Mike",(R),Mortgage Bankers Assn,42700,40000,2700
"Rounds, Mike",(R),Avairpros,42400,0,42400
"Rounds, Mike",(R),UBS Americas,40000,40000,0
"Rounds, Mike",(R),PNC Financial Services,39000,39000,0
"Rounds, Mike",(R),NextEra Energy,38700,16000,22700
"Rounds, Mike",(R),United Parcel Service,37585,37500,85
"Rounds, Mike",(R),Honeywell International,37150,37000,150
"Rounds, Mike",(R),Sanford Health,36050,0,36050
"Rounds, Mike",(R),Northrop Grumman,33600,31000,2600
"Rounds, Mike",(R),Lockheed Martin,32569,32500,69
"Rounds, Mike",(R),American Hotel & Lodging Assn,32500,32500,0
"Rounds, Mike",(R),Microsoft Corp,31050,30000,1050
"Rounds, Mike",(R),Independent Community Bankers of America,30500,30500,0
"Rounds, Mike",(R),First Premier Bank,29800,0,29800
"Rounds, Mike",(R),General Dynamics,29575,29500,75
"Rounds, Mike",(R),Capital Group Companies,29400,20000,9400
"Rounds, Mike",(R),American Bankers Assn,29025,26000,3025
"Rounds, Mike",(R),Ernst & Young,29000,28000,1000
"Rounds, Mike",(R),Citigroup Inc,27950,27500,450
"Rounds, Mike",(R),New York Life Insurance,27500,27500,0
"Rounds, Mike",(R),Investment Co Institute,27000,27000,0
"Rounds, Mike",(R),US Bancorp,26615,12500,14115
"Rounds, Mike",(R),Deloitte LLP,26515,25000,1515
"Rounds, Mike",(R),Berkshire Hathaway,26500,25000,1500
"Rounds, Mike",(R),iHeartMedia Inc,26500,26500,0
"Rounds, Mike",(R),National Multifamily Housing Council,26500,26500,0
"Rounds, Mike",(R),Poet LLC,26100,25000,1100
"Rounds, Mike",(R),1st Financial Bank USA,25600,0,25600
"Rounds, Mike",(R),American Institute of CPAs,25000,25000,0
"Rounds, Mike",(R),California Dairies Inc,25000,25000,0
"Rounds, Mike",(R),Independent Insurance Agents & Brokers of America,25000,25000,0
"Rounds, Mike",(R),Prudential Financial,25000,25000,0
"Rounds, Mike",(R),UnitedHealth Group,25000,25000,0
"Rounds, Mike",(R),State of South Dakota,23898,0,23898
"Rounds, Mike",(R),National Assn of Realtors,23500,23500,0
"Rounds, Mike",(R),Massachusetts Mutual Life Insurance,23000,23000,0
"Rounds, Mike",(R),Air Line Pilots Assn,22500,22500,0
"Rounds, Mike",(R),RTX Corp,22500,22500,0
"Rounds, Mike",(R),America's Credit Unions,22000,22000,0
"Rounds, Mike",(R),Visa Inc,22000,20500,1500
"Rounds, Mike",(R),JPMorgan Chase & Co,21750,15000,6750
"Rounds, Mike",(R),Cboe Global Markets,21500,18500,3000
"Rounds, Mike",(R),Walmart Inc,20610,20500,110
"Rounds, Mike",(R),AT&T Inc,20580,20500,80
"Rounds, Mike",(R),LPL Financial,20500,20500,0
"Rounds, Mike",(R),Rock Holdings,20300,17500,2800
"Rounds, Mike",(R),Comcast Corp,20000,20000,0
"Rounds, Mike",(R),Koch Industries,20000,20000,0
"Rounds, Mike",(R),Marathon Petroleum,20000,20000,0
"Rounds, Mike",(R),Aircraft Owners & Pilots Assn,19750,17500,2250
"Rounds, Mike",(R),Black Hills Corp,19500,15000,4500
"Rounds, Mike",(R),FMR Corp,19000,19000,0
"Rounds, Mike",(R),National Assn of Mutual Insurance Companies,19000,19000,0
"Rounds, Mike",(R),Boeing Co,18665,16000,2665
"Rounds, Mike",(R),American Chemistry Council,18500,18000,500
"Rounds, Mike",(R),Home Depot,18500,18500,0
"Rounds, Mike",(R),National Business Aviation Assn,18500,18500,0
"Rounds, Mike",(R),PricewaterhouseCoopers,18010,18000,10
"Rounds, Mike",(R),American Financial Services Assn,18000,18000,0
"Rounds, Mike",(R),Land O'Lakes,17525,10000,7525
"Rounds, Mike",(R),KPMG LLP,17500,17500,0
"Rounds, Mike",(R),Bockorny Group,16850,0,16850
"Rounds, Mike",(R),Alticor Inc,16800,0,16800
"Rounds, Mike",(R),Wells Fargo,16750,15000,1750
"Rounds, Mike",(R),Daktronics Inc,16600,0,16600
"Rounds, Mike",(R),Verizon Communications,16525,16000,525
"Rounds, Mike",(R),Goldman Sachs,16300,8500,7800
"Rounds, Mike",(R),FedEx Corp,16005,16000,5
"Rounds, Mike",(R),Bluff Point Assoc,16000,0,16000
"Rounds, Mike",(R),National Air Traffic Controllers Assn,16000,16000,0
"Rounds, Mike",(R),Thrivent Financial,16000,16000,0
"Rounds, Mike",(R),Avera Health Systems,15650,0,15650
"Rounds, Mike",(R),AFLAC Inc,15500,15500,0
"Rounds, Mike",(R),Allstate Insurance,15500,15500,0
"Rounds, Mike",(R),Civic Service Inc,15400,0,15400
"Rounds, Mike",(R),Cigna Corp,15150,15000,150
"Rounds, Mike",(R),Blackstone Group,15020,0,15020
"Rounds, Mike",(R),American Assn of Nurse Anesthetists,15000,15000,0
"Rounds, Mike",(R),Bank of New York Mellon,15000,15000,0
"Rounds, Mike",(R),Keeping Republican Ideas Strong Timely,15000,15000,0
"Rounds, Mike",(R),National Beer Wholesalers Assn,15000,15000,0
"Rounds, Mike",(R),Pinnacle West Capital,15000,15000,0
"Rounds, Mike",(R),International Assn of Fire Fighters,14500,14500,0
"Rounds, Mike",(R),Synchrony Financial,14500,14500,0
"Rounds, Mike",(R),Blessey Marine Service,14150,5000,9150
"Rounds, Mike",(R),American Property Casualty Insurance Assn,14000,14000,0
"Rounds, Mike",(R),National Assn of Broadcasters,14000,10000,4000
"Rounds, Mike",(R),Ecolab Inc,13500,13500,0
"Rounds, Mike",(R),Holland & Knight,13500,10500,3000
"Rounds, Mike",(R),Black Hills Harley-Davidson,13200,0,13200
"Rounds, Mike",(R),National Venture Capital Assn,13000,13000,0
"Rounds, Mike",(R),TCF Financial,13000,7500,5500
"Rounds, Mike",(R),Xcel Energy,13000,13000,0
"Rounds, Mike",(R),Capital Funding Group,12900,0,12900
"Rounds, Mike",(R),Kirby Financial,12900,0,12900
"Rounds, Mike",(R),"Akin, Gump et al",12850,4000,8850
"Rounds, Mike",(R),Vista Outdoor,12757,12757,0
"Rounds, Mike",(R),International Council of Shopping Centers,12625,12625,0
"Rounds, Mike",(R),Council of Insurance Agents & Brokers,12500,12500,0
"Rounds, Mike",(R),National Assn of Health Underwriters,12500,12500,0
"Rubio, Marco",(R),Club for Growth,275425,0,275425
"Rubio, Marco",(R),Elliott Management,194400,0,194400
"Rubio, Marco",(R),Votesane PAC,176125,0,176125
"Rubio, Marco",(R),The Villages,138105,0,138105
"Rubio, Marco",(R),Florida Crystals,122891,0,122891
"Rubio, Marco",(R),Blackstone Group,115190,0,115190
"Rubio, Marco",(R),NextEra Energy,104351,37500,66851
"Rubio, Marco",(R),Patrick P Lee Foundation,67800,0,67800
"Rubio, Marco",(R),Dwd Mechanical Contractor,64000,0,64000
"Rubio, Marco",(R),Goldman Sachs,63520,20000,43520
"Rubio, Marco",(R),Greenberg Traurig LLP,63075,2500,60575
"Rubio, Marco",(R),Melaleuca Inc,60195,0,60195
"Rubio, Marco",(R),GEO Group,59700,2500,57200
"Rubio, Marco",(R),MCNA Dental Plans,58650,0,58650
"Rubio, Marco",(R),NVR Inc,56000,0,56000
"Rubio, Marco",(R),Agree Realty,54000,0,54000
"Rubio, Marco",(R),Pence Group,54000,0,54000
"Rubio, Marco",(R),Bank of America,51235,6000,45235
"Rubio, Marco",(R),Northrop Grumman,50371,41500,8871
"Rubio, Marco",(R),Vestcor Companies,49826,0,49826
"Rubio, Marco",(R),Comcast Corp,49525,35000,14525
"Rubio, Marco",(R),Steward Health Care,49050,1000,48050
"Rubio, Marco",(R),CSX Corp,48900,43500,5400
"Rubio, Marco",(R),Equity Prime Mortgage,48700,0,48700
"Rubio, Marco",(R),National Republican Senatorial Cmte,48555,46800,1755
"Rubio, Marco",(R),DCI Group,46700,0,46700
"Rubio, Marco",(R),BGR Group,45420,500,44920
"Rubio, Marco",(R),Amway/Alticor Inc,45200,2000,43200
"Rubio, Marco",(R),AT&T Inc,44107,33500,10607
"Rubio, Marco",(R),Berkshire Hathaway,43277,26000,17277
"Rubio, Marco",(R),Johnson Controls International,43250,0,43250
"Rubio, Marco",(R),Reyes Holdings,43200,0,43200
"Rubio, Marco",(R),PNC Financial Services,42739,39500,3239
"Rubio, Marco",(R),Eastern Shipbuilding Group,42500,0,42500
"Rubio, Marco",(R),Wiley Rein LLP,42200,0,42200
"Rubio, Marco",(R),Walt Disney Co,42015,34750,7265
"Rubio, Marco",(R),American Bankers Assn,42000,40000,2000
"Rubio, Marco",(R),GL Homes of Florida,41600,0,41600
"Rubio, Marco",(R),COLSA Corp,41400,0,41400
"Rubio, Marco",(R),Swanson Vineyards,40856,0,40856
"Rubio, Marco",(R),Deloitte LLP,40845,37500,3345
"Rubio, Marco",(R),Privet Fund Management,40840,0,40840
"Rubio, Marco",(R),Shotgun Creek Investments,40500,0,40500
"Rubio, Marco",(R),Southern Co,40225,28000,12225
"Rubio, Marco",(R),Putnam Investments,39930,1530,38400
"Rubio, Marco",(R),Walmart Inc,39298,28500,10798
"Rubio, Marco",(R),Lockheed Martin,38445,35500,2945
"Rubio, Marco",(R),Demetree Global,38260,0,38260
"Rubio, Marco",(R),General Atomics,38200,17000,21200
"Rubio, Marco",(R),T&D Concrete,37800,0,37800
"Rubio, Marco",(R),Northwest Excavating,36600,0,36600
"Rubio, Marco",(R),RTX Corp,36525,35000,1525
"Rubio, Marco",(R),Passion Growers,36500,0,36500
"Rubio, Marco",(R),"Akin, Gump et al",35925,17000,18925
"Rubio, Marco",(R),Baker Botts LLP,35895,0,35895
"Rubio, Marco",(R),Publix Super Markets,35210,12000,23210
"Rubio, Marco",(R),Advent International,35100,0,35100
"Rubio, Marco",(R),AmerisourceBergen Corp,35025,30000,5025
"Rubio, Marco",(R),American Hotel & Lodging Assn,35000,35000,0
"Rubio, Marco",(R),Northeast Remsco Construction,34600,0,34600
"Rubio, Marco",(R),Navigators Global,34000,0,34000
"Rubio, Marco",(R),TigerRisk Partners,33900,0,33900
"Rubio, Marco",(R),Wells Fargo,33820,10000,23820
"Rubio, Marco",(R),Perry Ellis International,33800,0,33800
"Rubio, Marco",(R),L3Harris Technologies,33016,32500,516
"Rubio, Marco",(R),Hilton Inn Resort,32600,0,32600
"Rubio, Marco",(R),Citizens First Bank,32400,0,32400
"Rubio, Marco",(R),"Freeman, Mathis & Gary",32400,0,32400
"Rubio, Marco",(R),Hunt Consolidated,32400,0,32400
"Rubio, Marco",(R),Sequoia Capital,32400,0,32400
"Rubio, Marco",(R),Jennmar Corp,31800,0,31800
"Rubio, Marco",(R),Pattco Inc,31640,0,31640
"Rubio, Marco",(R),Prescott Investors,31600,0,31600
"Rubio, Marco",(R),Verizon Communications,31590,31000,590
"Rubio, Marco",(R),Apollo Global Management,30411,13500,16911
"Rubio, Marco",(R),Oxbow Corp,30300,15000,15300
"Rubio, Marco",(R),LPL Investment Group,30240,0,30240
"Rubio, Marco",(R),Dimare Homestead,30230,0,30230
"Rubio, Marco",(R),Honeywell International,30050,26500,3550
"Rubio, Marco",(R),Fidelity Investments,30000,2000,28000
"Rubio, Marco",(R),National Multifamily Housing Council,30000,30000,0
"Rubio, Marco",(R),Penn Capital Management,29800,0,29800
"Rubio, Marco",(R),McM Corp,29700,0,29700
"Rubio, Marco",(R),Fidelity National Information Services,29620,0,29620
"Rubio, Marco",(R),United Parcel Service,29570,18500,11070
"Rubio, Marco",(R),MBB Auto LLC,29300,0,29300
"Rubio, Marco",(R),Gioia Management Group,29280,0,29280
"Rubio, Marco",(R),FedEx Corp,29163,28000,1163
"Rubio, Marco",(R),Hamister Group,29000,0,29000
"Rubio, Marco",(R),Pfizer Inc,28700,27000,1700
"Rubio, Marco",(R),Artmarina Inc,28400,0,28400
"Rubio, Marco",(R),Asher's Chocolates,28300,0,28300
"Rubio, Marco",(R),National Assn of Broadcasters,28300,20000,8300
"Rubio, Marco",(R),Las Vegas Sands,28100,10000,18100
"Rubio, Marco",(R),Marine Concepts,27725,0,27725
"Rubio, Marco",(R),Century Homebuilders,27600,0,27600
"Rubio, Marco",(R),American Institute of CPAs,27500,27500,0
"Rubio, Marco",(R),National Assn of Convenience Stores,27500,27500,0
"Rubio, Marco",(R),General Dynamics,27050,22500,4550
"Rubio, Marco",(R),Dade County Public Schools,27025,0,27025
"Sanders, Bernie",(I),University of California,68023,0,68023
"Sanders, Bernie",(I),Amazon.com,30664,0,30664
"Sanders, Bernie",(I),Alphabet Inc,30101,0,30101
"Sanders, Bernie",(I),"City of New York, NY",25482,0,25482
"Sanders, Bernie",(I),American Postal Workers Union,25233,15000,10233
"Sanders, Bernie",(I),US Postal Service,22653,0,22653
"Sanders, Bernie",(I),Kaiser Permanente,22328,0,22328
"Sanders, Bernie",(I),Microsoft Corp,21478,0,21478
"Sanders, Bernie",(I),University of Michigan,20203,0,20203
"Sanders, Bernie",(I),Apple Inc,18968,0,18968
"Sanders, Bernie",(I),AT&T Inc,16062,0,16062
"Sanders, Bernie",(I),State of California,15357,0,15357
"Sanders, Bernie",(I),City University of New York,15045,0,15045
"Sanders, Bernie",(I),Boeing Co,14993,0,14993
"Sanders, Bernie",(I),University of Washington,14700,0,14700
"Sanders, Bernie",(I),California State University,14470,0,14470
"Sanders, Bernie",(I),University of Maryland,14315,0,14315
"Sanders, Bernie",(I),University of Illinois,14139,0,14139
"Sanders, Bernie",(I),Columbia University,13289,0,13289
"Sanders, Bernie",(I),Los Angeles Unified School District,13252,0,13252
"Sanders, Bernie",(I),Service Employees International Union,13195,5000,8195
"Sanders, Bernie",(I),Harvard University,12768,0,12768
"Sanders, Bernie",(I),IBM Corp,12415,0,12415
"Sanders, Bernie",(I),Machinists/Aerospace Workers Union,12030,7000,5030
"Sanders, Bernie",(I),US Dept of Veterans Affairs,11763,0,11763
"Sanders, Bernie",(I),Stanford University,11595,0,11595
"Sanders, Bernie",(I),US Government,11222,0,11222
"Sanders, Bernie",(I),Moveon.org,10849,10000,849
"Sanders, Bernie",(I),University of Wisconsin,10779,0,10779
"Sanders, Bernie",(I),Walt Disney Co,10306,0,10306
"Sanders, Bernie",(I),American Federation of Teachers,10274,10000,274
"Sanders, Bernie",(I),American Federation of Government Employees,10089,10000,89
"Sanders, Bernie",(I),Transport Workers Union,10050,10000,50
"Sanders, Bernie",(I),America Works,10010,10000,10
"Sanders, Bernie",(I),Fearless for the People,10000,10000,0
"Sanders, Bernie",(I),University of Texas,9450,0,9450
"Sanders, Bernie",(I),US Navy,9378,0,9378
"Sanders, Bernie",(I),Yale University,9162,0,9162
"Sanders, Bernie",(I),US Army,9090,0,9090
"Sanders, Bernie",(I),National Nurses United,8911,3500,5411
"Sanders, Bernie",(I),United Parcel Service,8842,0,8842
"Sanders, Bernie",(I),US Air Force,8808,0,8808
"Sanders, Bernie",(I),Walmart Inc,8729,0,8729
"Sanders, Bernie",(I),Blue Cross/Blue Shield,8712,0,8712
"Sanders, Bernie",(I),Pacific Gourmet,8693,0,8693
"Sanders, Bernie",(I),Comcast Corp,8615,0,8615
"Sanders, Bernie",(I),US Dept of Defense,8236,0,8236
"Sanders, Bernie",(I),Dell Technologies,7962,0,7962
"Sanders, Bernie",(I),State of New York,7960,0,7960
"Sanders, Bernie",(I),Communications Workers of America,7958,6500,1458
"Sanders, Bernie",(I),State University of New York,7789,0,7789
"Sanders, Bernie",(I),Oracle Corp,7773,0,7773
"Sanders, Bernie",(I),National Education Assn,7769,5000,2769
"Sanders, Bernie",(I),New York University,7739,0,7739
"Sanders, Bernie",(I),Indiana University,7703,0,7703
"Sanders, Bernie",(I),University of Chicago,7546,0,7546
"Sanders, Bernie",(I),Climate Champions PAC,7500,7500,0
"Sanders, Bernie",(I),Cornell University,7466,0,7466
"Sanders, Bernie",(I),Dept of Children & Family Services,7400,0,7400
"Sanders, Bernie",(I),United Steelworkers,7314,7000,314
"Sanders, Bernie",(I),University of Minnesota,7062,0,7062
"Sanders, Bernie",(I),University of North Carolina,7028,0,7028
"Sanders, Bernie",(I),National Assn of Letter Carriers,7010,7000,10
"Sanders, Bernie",(I),Wells Fargo,6931,0,6931
"Sanders, Bernie",(I),Mass General Brigham,6917,0,6917
"Sanders, Bernie",(I),Teamsters Union,6908,5800,1108
"Sanders, Bernie",(I),Intel Corp,6675,0,6675
"Sanders, Bernie",(I),Verizon Communications,6603,0,6603
"Sanders, Bernie",(I),Starbucks Corp,6570,0,6570
"Sanders, Bernie",(I),Kroger Co,6409,0,6409
"Sanders, Bernie",(I),"Quinn, Emanuel et al",6218,0,6218
"Sanders, Bernie",(I),Creighton University,6175,0,6175
"Sanders, Bernie",(I),US Dept of State,6174,0,6174
"Sanders, Bernie",(I),JPMorgan Chase & Co,6118,0,6118
"Sanders, Bernie",(I),Johns Hopkins University,6042,0,6042
"Sanders, Bernie",(I),"City & County of San Francisco, CA",6031,0,6031
"Sanders, Bernie",(I),Galloway Group,5991,0,5991
"Sanders, Bernie",(I),Commonwealth of Massachusetts,5955,0,5955
"Sanders, Bernie",(I),UnitedHealth Group,5950,0,5950
"Sanders, Bernie",(I),American Airlines Group,5936,0,5936
"Sanders, Bernie",(I),US Dept of Health & Human Services,5877,0,5877
"Sanders, Bernie",(I),Operating Engineers Union,5862,5000,862
"Sanders, Bernie",(I),Salesforce.Com,5822,0,5822
"Sanders, Bernie",(I),Cybersonics Inc,5775,0,5775
"Sanders, Bernie",(I),University of Massachusetts,5733,0,5733
"Sanders, Bernie",(I),University of Pennsylvania,5687,0,5687
"Sanders, Bernie",(I),"Los Angeles County, CA",5662,0,5662
"Sanders, Bernie",(I),J Street,5510,5000,510
"Sanders, Bernie",(I),Morgan Lewis LLP,5506,0,5506
"Sanders, Bernie",(I),Mayo Clinic,5490,0,5490
"Sanders, Bernie",(I),Facebook Inc,5452,0,5452
"Sanders, Bernie",(I),United Airlines Holdings,5425,0,5425
"Sanders, Bernie",(I),Abbey Foods,5400,0,5400
"Sanders, Bernie",(I),St Mungo's,5400,0,5400
"Sanders, Bernie",(I),Washington Intern Student Housing,5400,0,5400
"Sanders, Bernie",(I),"Williams, Hart et al",5400,0,5400
"Sanders, Bernie",(I),University of Vermont,5355,0,5355
"Sanders, Bernie",(I),Accenture,5308,0,5308
"Sanders, Bernie",(I),Target Corp,5282,0,5282
"Sanders, Bernie",(I),Home Depot,5274,0,5274
"Sasse, Ben",(R),Capital Group Companies,123200,25000,98200
"Sasse, Ben",(R),Mountain Group Partners,89400,0,89400
"Sasse, Ben",(R),DCI Group,58500,5000,53500
"Sasse, Ben",(R),Club for Growth,49801,0,49801
"Sasse, Ben",(R),Union Pacific Corp,45855,40000,5855
"Sasse, Ben",(R),Berkshire Hathaway,37550,37500,50
"Sasse, Ben",(R),American Bankers Assn,36050,35000,1050
"Sasse, Ben",(R),PNC Financial Services,36000,36000,0
"Sasse, Ben",(R),Honeywell International,35105,35000,105
"Sasse, Ben",(R),Norfolk Southern,35050,35000,50
"Sasse, Ben",(R),Mortgage Bankers Assn,35000,35000,0
"Sasse, Ben",(R),Stephens Inc,31600,0,31600
"Sasse, Ben",(R),Google Inc,30225,15000,15225
"Sasse, Ben",(R),CSX Corp,30000,30000,0
"Sasse, Ben",(R),NorPAC,29300,0,29300
"Sasse, Ben",(R),Rayes Inc,28900,0,28900
"Sasse, Ben",(R),Northrop Grumman,27755,27500,255
"Sasse, Ben",(R),AFLAC Inc,27500,27500,0
"Sasse, Ben",(R),Microsoft Corp,27420,18000,9420
"Sasse, Ben",(R),KPMG LLP,27075,27000,75
"Sasse, Ben",(R),Comcast Corp,26500,26500,0
"Sasse, Ben",(R),National Assn of Broadcasters,26500,23500,3000
"Sasse, Ben",(R),Madison Dearborn Partners,26300,0,26300
"Sasse, Ben",(R),Bluff Point Assoc,26200,0,26200
"Sasse, Ben",(R),American Institute of CPAs,25000,25000,0
"Sasse, Ben",(R),Independent Insurance Agents & Brokers of America,25000,25000,0
"Sasse, Ben",(R),Alston & Bird,24800,6500,18300
"Sasse, Ben",(R),AT&T Inc,24002,24000,2
"Sasse, Ben",(R),DaVita Inc,24000,24000,0
"Sasse, Ben",(R),National Assn of Realtors,23500,23500,0
"Sasse, Ben",(R),Avista Capital Partners,23400,0,23400
"Sasse, Ben",(R),Affiliated Managers Group,23000,0,23000
"Sasse, Ben",(R),Civic Service Inc,23000,0,23000
"Sasse, Ben",(R),Ernst & Young,23000,22500,500
"Sasse, Ben",(R),Liberty Mutual Insurance,23000,23000,0
"Sasse, Ben",(R),Charles Schwab Corp,22900,10500,12400
"Sasse, Ben",(R),United Parcel Service,22525,22500,25
"Sasse, Ben",(R),Humana Inc,22500,22500,0
"Sasse, Ben",(R),Prudential Financial,22500,8500,14000
"Sasse, Ben",(R),Boston Consulting Group,22200,0,22200
"Sasse, Ben",(R),Crow Holdings,21600,0,21600
"Sasse, Ben",(R),Wholesale & Specialty Insurance Assn,21500,21500,0
"Sasse, Ben",(R),Yancey Brothers,21100,0,21100
"Sasse, Ben",(R),Council of Insurance Agents & Brokers,21000,21000,0
"Sasse, Ben",(R),Goldman Sachs,21000,15000,6000
"Sasse, Ben",(R),United Distributors,20900,0,20900
"Sasse, Ben",(R),Arbiter Partners,20800,0,20800
"Sasse, Ben",(R),State of Tennessee,20525,0,20525
"Sasse, Ben",(R),America's Credit Unions,20500,20500,0
"Sasse, Ben",(R),Centene Corp,20500,1500,19000
"Sasse, Ben",(R),Independent Community Bankers of America,20500,20500,0
"Sasse, Ben",(R),UBS Americas,20500,20000,500
"Sasse, Ben",(R),Deloitte LLP,20005,20000,5
"Sasse, Ben",(R),USAA,20001,20000,1
"Sasse, Ben",(R),Enterprise Holdings,20000,20000,0
"Sasse, Ben",(R),Koch Industries,20000,20000,0
"Sasse, Ben",(R),Fidelity Investments,19700,17000,2700
"Sasse, Ben",(R),Rdv Corp,19600,0,19600
"Sasse, Ben",(R),PricewaterhouseCoopers,19500,18500,1000
"Sasse, Ben",(R),Regions Financial,19500,19500,0
"Sasse, Ben",(R),Susquehanna International Group,18700,0,18700
"Sasse, Ben",(R),US-Cuba Democracy PAC,18500,18500,0
"Sasse, Ben",(R),AEA Investors,18300,0,18300
"Sasse, Ben",(R),"Pachulski, Stang et al",18300,0,18300
"Sasse, Ben",(R),Hackman Capital Partners,18100,0,18100
"Sasse, Ben",(R),Citadel LLC,18000,0,18000
"Sasse, Ben",(R),Mt Vernon Investments,18000,0,18000
"Sasse, Ben",(R),Platte River Ventures,18000,0,18000
"Sasse, Ben",(R),"Paul, Weiss et al",17800,0,17800
"Sasse, Ben",(R),National Assn of Mutual Insurance Companies,17500,17500,0
"Sasse, Ben",(R),Blackstone Group,16800,0,16800
"Sasse, Ben",(R),Tenaska Inc,16583,7500,9083
"Sasse, Ben",(R),Verisk Analytics,16200,0,16200
"Sasse, Ben",(R),Charter Communications,16000,16000,0
"Sasse, Ben",(R),FedEx Corp,16000,16000,0
"Sasse, Ben",(R),JW Childs Assoc,16000,0,16000
"Sasse, Ben",(R),National Assn of Real Estate Investment Trusts,16000,16000,0
"Sasse, Ben",(R),Ryan Specialty Group,16000,0,16000
"Sasse, Ben",(R),Bluewater International,15600,0,15600
"Sasse, Ben",(R),Blue Cross/Blue Shield,15500,14500,1000
"Sasse, Ben",(R),General Motors,15500,15500,0
"Sasse, Ben",(R),National Multifamily Housing Council,15500,15500,0
"Sasse, Ben",(R),Uline Inc,15500,0,15500
"Sasse, Ben",(R),Zurich Insurance Group,15250,10000,5250
"Sasse, Ben",(R),Home Depot,15035,15000,35
"Sasse, Ben",(R),Southern Co,15020,15000,20
"Sasse, Ben",(R),American Crystal Sugar,15000,15000,0
"Sasse, Ben",(R),American Express,15000,15000,0
"Sasse, Ben",(R),GEO Group,15000,10000,5000
"Sasse, Ben",(R),National Beer Wholesalers Assn,15000,15000,0
"Sasse, Ben",(R),NelNet Inc,15000,15000,0
"Sasse, Ben",(R),Pacific Life Insurance,15000,15000,0
"Sasse, Ben",(R),Wine & Spirits Wholesalers of America,15000,15000,0
"Sasse, Ben",(R),T-Mobile USA,14525,14500,25
"Sasse, Ben",(R),Truist Financial,14500,13500,1000
"Sasse, Ben",(R),GBX Group,14000,0,14000
"Sasse, Ben",(R),Lumen Technologies,14000,14000,0
"Sasse, Ben",(R),Morgan Stanley,14000,6500,7500
"Sasse, Ben",(R),TCF Financial,13950,5000,8950
"Sasse, Ben",(R),Aaron's Inc,13500,11000,2500
"Schatz, Brian",(D),League of Conservation Voters,113278,12000,101278
"Schatz, Brian",(D),Votesane PAC,95500,0,95500
"Schatz, Brian",(D),DISH Network,53900,35000,18900
"Schatz, Brian",(D),Clarkson Aerospace,53500,0,53500
"Schatz, Brian",(D),Comcast Corp,50700,30000,20700
"Schatz, Brian",(D),Matson Inc,50099,10680,39419
"Schatz, Brian",(D),AT&T Inc,48500,46500,2000
"Schatz, Brian",(D),Verizon Communications,48500,47500,1000
"Schatz, Brian",(D),National Assn of Broadcasters,46000,44500,1500
"Schatz, Brian",(D),Union Pacific Corp,42500,42500,0
"Schatz, Brian",(D),Cox Enterprises,42400,28500,13900
"Schatz, Brian",(D),"Kobayashi, Sugita & Goda",41918,0,41918
"Schatz, Brian",(D),National Air Traffic Controllers Assn,40000,40000,0
"Schatz, Brian",(D),Wine & Spirits Wholesalers of America,40000,40000,0
"Schatz, Brian",(D),Google Inc,39306,27500,11806
"Schatz, Brian",(D),NCTA The Internet & Television Assn,38500,37500,1000
"Schatz, Brian",(D),MacAndrews & Forbes,38100,21000,17100
"Schatz, Brian",(D),JStreetPAC,37610,2500,35110
"Schatz, Brian",(D),Honeywell International,37525,35500,2025
"Schatz, Brian",(D),Ford Motor Co,36501,35000,1501
"Schatz, Brian",(D),Berkshire Hathaway,35503,35000,503
"Schatz, Brian",(D),Hawaiian Airlines,35184,20200,14984
"Schatz, Brian",(D),CSX Corp,35000,35000,0
"Schatz, Brian",(D),International Brotherhood of Electrical Workers,35000,35000,0
"Schatz, Brian",(D),Seafarers International Union,35000,33750,1250
"Schatz, Brian",(D),American Hotel & Lodging Assn,32500,32500,0
"Schatz, Brian",(D),Charter Communications,32500,32500,0
"Schatz, Brian",(D),Norfolk Southern,32500,32500,0
"Schatz, Brian",(D),Saltchuk,32500,17500,15000
"Schatz, Brian",(D),Alexander & Baldwin,32000,13000,19000
"Schatz, Brian",(D),CGS Assoc,30200,0,30200
"Schatz, Brian",(D),Deloitte LLP,30003,30000,3
"Schatz, Brian",(D),Air Line Pilots Assn,30000,30000,0
"Schatz, Brian",(D),Mortgage Bankers Assn,30000,30000,0
"Schatz, Brian",(D),Prairie PAC,30000,30000,0
"Schatz, Brian",(D),General Dynamics,29500,29500,0
"Schatz, Brian",(D),National Assn of Realtors,29500,29500,0
"Schatz, Brian",(D),Quicken Loans,29200,5000,24200
"Schatz, Brian",(D),Huntington Ingalls Industries,29000,29000,0
"Schatz, Brian",(D),First Hawaiian Bank,27500,2700,24800
"Schatz, Brian",(D),iHeartMedia Inc,27500,17500,10000
"Schatz, Brian",(D),Hewlett Packard Enterprise,27000,27000,0
"Schatz, Brian",(D),Walt Disney Co,27000,27000,0
"Schatz, Brian",(D),Microsoft Corp,26610,26500,110
"Schatz, Brian",(D),Hawaiian Electric Industries,26450,0,26450
"Schatz, Brian",(D),KPMG LLP,26000,23500,2500
"Schatz, Brian",(D),Shidler Group,25800,0,25800
"Schatz, Brian",(D),BAE Systems,25100,24000,1100
"Schatz, Brian",(D),National Assn of Letter Carriers,25000,25000,0
"Schatz, Brian",(D),Purpose PAC,25000,25000,0
"Schatz, Brian",(D),T-Mobile USA,24500,23000,1500
"Schatz, Brian",(D),"Alston, Hunt et al",23909,0,23909
"Schatz, Brian",(D),Hawaiian Telcom,23400,7000,16400
"Schatz, Brian",(D),American Federation of Government Employees,23000,23000,0
"Schatz, Brian",(D),RTX Corp,22500,22500,0
"Schatz, Brian",(D),Thornton Law Firm,22500,0,22500
"Schatz, Brian",(D),Blue Cross/Blue Shield,22410,1000,21410
"Schatz, Brian",(D),North Star Scientific,22200,0,22200
"Schatz, Brian",(D),L3Harris Technologies,21500,21500,0
"Schatz, Brian",(D),Martin Defense Group,21500,0,21500
"Schatz, Brian",(D),American Institute of CPAs,21000,21000,0
"Schatz, Brian",(D),Hilton Worldwide,21000,16000,5000
"Schatz, Brian",(D),Intel Corp,21000,20000,1000
"Schatz, Brian",(D),CHEROKEE NATION,20900,0,20900
"Schatz, Brian",(D),NextEra Energy,20500,20000,500
"Schatz, Brian",(D),Northstar Realty Finance,20400,0,20400
"Schatz, Brian",(D),Vitus Group,20400,0,20400
"Schatz, Brian",(D),"Akin, Gump et al",20250,5500,14750
"Schatz, Brian",(D),HDR Inc,20243,19000,1243
"Schatz, Brian",(D),Facebook Inc,20000,20000,0
"Schatz, Brian",(D),PricewaterhouseCoopers,19500,19500,0
"Schatz, Brian",(D),Glover Park Group,19450,5050,14400
"Schatz, Brian",(D),Wiley Rein LLP,19200,0,19200
"Schatz, Brian",(D),CTIA,18500,18500,0
"Schatz, Brian",(D),Strategies 360,18499,0,18499
"Schatz, Brian",(D),Carnival Corp,18400,1500,16900
"Schatz, Brian",(D),Pop Fishing & Marine,18400,0,18400
"Schatz, Brian",(D),ATS Communications,18200,0,18200
"Schatz, Brian",(D),Chickasaw Nation,18100,0,18100
"Schatz, Brian",(D),General Motors,18000,18000,0
"Schatz, Brian",(D),Chugach Alaska,17500,17500,0
"Schatz, Brian",(D),Communications Workers of America,17500,17500,0
"Schatz, Brian",(D),National Multifamily Housing Council,17500,17500,0
"Schatz, Brian",(D),US Travel Assn,17500,17500,0
"Schatz, Brian",(D),Pacific Defense Solutions,17305,0,17305
"Schatz, Brian",(D),United Fishing Agency,17300,0,17300
"Schatz, Brian",(D),Cornerstone Government Affairs,16900,0,16900
"Schatz, Brian",(D),Ocean Champions,16578,9078,7500
"Schatz, Brian",(D),Imanaka Asato LLC,16550,0,16550
"Schatz, Brian",(D),Lockheed Martin,16500,16500,0
"Schatz, Brian",(D),Lumen Technologies,16500,14000,2500
"Schatz, Brian",(D),Northrop Grumman,16500,16500,0
"Schatz, Brian",(D),Marine Engineers Beneficial Assn,16485,14583,1902
"Schatz, Brian",(D),"Leavitt, Yamane & Soldner",16450,0,16450
"Schatz, Brian",(D),National Marine Manufacturers Assn,16000,12500,3500
"Schatz, Brian",(D),America's Credit Unions,15500,15000,500
"Schatz, Brian",(D),Emerson Collective,15500,0,15500
"Schatz, Brian",(D),Blue Origin,15400,15400,0
"Schatz, Brian",(D),Nike Inc,15050,15000,50
"Schatz, Brian",(D),America Works,15000,15000,0
"Schumer, Charles E",(D),New York Life Insurance,164183,44000,120183
"Schumer, Charles E",(D),Lockheed Martin,144160,50000,94160
"Schumer, Charles E",(D),"Paul, Weiss et al",143105,0,143105
"Schumer, Charles E",(D),Deloitte LLP,132284,40000,92284
"Schumer, Charles E",(D),PricewaterhouseCoopers,131605,42500,89105
"Schumer, Charles E",(D),MetLife Inc,122441,36500,85941
"Schumer, Charles E",(D),NorPAC,117368,0,117368
"Schumer, Charles E",(D),Google Inc,115751,31500,84251
"Schumer, Charles E",(D),KPMG LLP,113805,36000,77805
"Schumer, Charles E",(D),Corning Inc,112120,35000,77120
"Schumer, Charles E",(D),Cisco Systems,99040,25000,74040
"Schumer, Charles E",(D),Microsoft Corp,96127,44500,51627
"Schumer, Charles E",(D),Ernst & Young,94620,35500,59120
"Schumer, Charles E",(D),Capital Group Companies,94200,35000,59200
"Schumer, Charles E",(D),UnitedHealth Group,89569,36000,53569
"Schumer, Charles E",(D),Goldman Sachs,88025,45000,43025
"Schumer, Charles E",(D),Blue Cross/Blue Shield,87039,66000,21039
"Schumer, Charles E",(D),NextEra Energy,81425,26500,54925
"Schumer, Charles E",(D),National Assn of Broadcasters,80852,45500,35352
"Schumer, Charles E",(D),Apple Inc,80161,0,80161
"Schumer, Charles E",(D),Apollo Global Management,76044,17000,59044
"Schumer, Charles E",(D),Visa Inc,73798,34000,39798
"Schumer, Charles E",(D),Blackstone Group,73503,0,73503
"Schumer, Charles E",(D),Centene Corp,72338,41000,31338
"Schumer, Charles E",(D),Bank of New York Mellon,70175,30000,40175
"Schumer, Charles E",(D),League of Conservation Voters,69912,14500,55412
"Schumer, Charles E",(D),CVS Health,69758,66000,3758
"Schumer, Charles E",(D),DaVita Inc,69735,41500,28235
"Schumer, Charles E",(D),Pershing Square Capital Management,69700,0,69700
"Schumer, Charles E",(D),AFLAC Inc,68679,40000,28679
"Schumer, Charles E",(D),American Express,66985,35000,31985
"Schumer, Charles E",(D),Access Industries,66400,0,66400
"Schumer, Charles E",(D),Renaissance Technologies,64800,0,64800
"Schumer, Charles E",(D),Sullivan & Cromwell,63615,0,63615
"Schumer, Charles E",(D),York Capital Management,63500,0,63500
"Schumer, Charles E",(D),ViacomCBS Inc,62205,0,62205
"Schumer, Charles E",(D),"Akin, Gump et al",62105,12600,49505
"Schumer, Charles E",(D),Silver Lake Partners,61805,5000,56805
"Schumer, Charles E",(D),Boeing Co,60182,40000,20182
"Schumer, Charles E",(D),Wirtz Corp,60000,0,60000
"Schumer, Charles E",(D),Walt Disney Co,59183,37500,21683
"Schumer, Charles E",(D),Vornado Realty Trust,59000,0,59000
"Schumer, Charles E",(D),"Newmark, Grubb et al",58500,0,58500
"Schumer, Charles E",(D),Constellation Brands,55600,34000,21600
"Schumer, Charles E",(D),KKR & Co,55447,11000,44447
"Schumer, Charles E",(D),American Hospital Assn,54900,40000,14900
"Schumer, Charles E",(D),Durst Organization,54700,0,54700
"Schumer, Charles E",(D),General Electric,52169,20000,32169
"Schumer, Charles E",(D),Votesane PAC,51500,0,51500
"Schumer, Charles E",(D),New York-Presbyterian Hospital,51415,0,51415
"Schumer, Charles E",(D),Honeywell International,50236,50000,236
"Schumer, Charles E",(D),MasterCard Inc,50105,14000,36105
"Schumer, Charles E",(D),DISH Network,49600,27500,22100
"Schumer, Charles E",(D),Facebook Inc,48910,14000,34910
"Schumer, Charles E",(D),"Brownstein, Hyatt et al",48650,16500,32150
"Schumer, Charles E",(D),MacAndrews & Forbes,48110,5000,43110
"Schumer, Charles E",(D),Altria Group,47800,45000,2800
"Schumer, Charles E",(D),Massachusetts Mutual Life Insurance,47800,28500,19300
"Schumer, Charles E",(D),RTX Corp,47644,47500,144
"Schumer, Charles E",(D),UBS AG,47588,32500,15088
"Schumer, Charles E",(D),Crowell & Moring,47000,25400,21600
"Schumer, Charles E",(D),America's Credit Unions,46000,46000,0
"Schumer, Charles E",(D),Wells Fargo,45447,6500,38947
"Schumer, Charles E",(D),Humana Inc,45035,45000,35
"Schumer, Charles E",(D),International Assn of Fire Fighters,45000,45000,0
"Schumer, Charles E",(D),Mortgage Bankers Assn,45000,45000,0
"Schumer, Charles E",(D),National Beer Wholesalers Assn,45000,45000,0
"Schumer, Charles E",(D),Broadridge Financial Solutions,44666,0,44666
"Schumer, Charles E",(D),Berkshire Hathaway,44104,34500,9604
"Schumer, Charles E",(D),Charter Communications,44005,44000,5
"Schumer, Charles E",(D),AT&T Inc,43507,35500,8007
"Schumer, Charles E",(D),National Air Traffic Controllers Assn,43500,43500,0
"Schumer, Charles E",(D),Nix Patterson LLP,43200,0,43200
"Schumer, Charles E",(D),Paulson & Co,43100,0,43100
"Schumer, Charles E",(D),Merck & Co,43033,43000,33
"Schumer, Charles E",(D),National Education Assn,42768,40000,2768
"Schumer, Charles E",(D),American Health Care Assn,42500,37500,5000
"Schumer, Charles E",(D),American Property Casualty Insurance Assn,42500,42500,0
"Schumer, Charles E",(D),Council of Insurance Agents & Brokers,42500,42500,0
"Schumer, Charles E",(D),M&T Bank,42485,1000,41485
"Schumer, Charles E",(D),Bank Of America,42389,37500,4889
"Schumer, Charles E",(D),Oaktree Capital Management,41801,0,41801
"Schumer, Charles E",(D),FedEx Corp,41593,41500,93
"Schumer, Charles E",(D),Pfizer Inc,41056,40500,556
"Schumer, Charles E",(D),Cardinal Health,40414,40000,414
"Schumer, Charles E",(D),Comcast Corp,40256,40000,256
"Schumer, Charles E",(D),Carlyle Group,40120,0,40120
"Schumer, Charles E",(D),International Brotherhood of Electrical Workers,40065,40000,65
"Schumer, Charles E",(D),General Motors,40034,40000,34
"Schumer, Charles E",(D),Independent Community Bankers of America,40000,40000,0
"Schumer, Charles E",(D),National Assn of Home Builders,40000,40000,0
"Schumer, Charles E",(D),National Multifamily Housing Council,40000,40000,0
"Schumer, Charles E",(D),Kirkland & Ellis,39939,0,39939
"Schumer, Charles E",(D),NASCAR,39700,10000,29700
"Schumer, Charles E",(D),Ford Motor Co,39515,39500,15
"Schumer, Charles E",(D),Eli Lilly & Co,39500,39500,0
"Schumer, Charles E",(D),"Lieff, Cabraser et al",39353,0,39353
"Schumer, Charles E",(D),Guardian Life Insurance,39300,7500,31800
"Schumer, Charles E",(D),WPP plc,39226,1500,37726
"Schumer, Charles E",(D),National Assn of Real Estate Investment Trusts,39000,39000,0
"Scott, Rick",(R),Club for Growth,167674,0,167674
"Scott, Rick",(R),The Villages,136550,0,136550
"Scott, Rick",(R),NextEra Energy,102500,16000,86500
"Scott, Rick",(R),GEO Group,80400,15000,65400
"Scott, Rick",(R),Home Depot,65664,20000,45664
"Scott, Rick",(R),Shutts & Bowen,60131,0,60131
"Scott, Rick",(R),Heartland Dental Care,44740,0,44740
"Scott, Rick",(R),Bank of America,42625,0,42625
"Scott, Rick",(R),State Farm Insurance,38921,0,38921
"Scott, Rick",(R),Lewis Bear Co,37800,0,37800
"Scott, Rick",(R),US Senate,37412,0,37412
"Scott, Rick",(R),RTX Corp,35925,5000,30925
"Scott, Rick",(R),Sj Lockwood & Co,34700,0,34700
"Scott, Rick",(R),Ryan LLC,33300,22500,10800
"Scott, Rick",(R),Banknote Capital,32000,0,32000
"Scott, Rick",(R),Sutton Properties,31200,0,31200
"Scott, Rick",(R),Greenberg Traurig LLP,31100,0,31100
"Scott, Rick",(R),Beasley Media Group,30300,0,30300
"Scott, Rick",(R),HCA Inc,29801,15000,14801
"Scott, Rick",(R),Full Sail,27750,0,27750
"Scott, Rick",(R),Select Medical Corp,27500,20000,7500
"Scott, Rick",(R),Republican Jewish Coalition,27490,10000,17490
"Scott, Rick",(R),Amscot Financial,26600,0,26600
"Scott, Rick",(R),Weathertech,26600,0,26600
"Scott, Rick",(R),Patrick P Lee Foundation,26200,0,26200
"Scott, Rick",(R),Equity Group Investments,25800,10000,15800
"Scott, Rick",(R),Cassidy Organization,25600,0,25600
"Scott, Rick",(R),State of Florida,25474,0,25474
"Scott, Rick",(R),Berkshire Hathaway,24830,20000,4830
"Scott, Rick",(R),Dex Imaging,24300,0,24300
"Scott, Rick",(R),Florida Crystals,24300,0,24300
"Scott, Rick",(R),T&D Concrete,24300,0,24300
"Scott, Rick",(R),York Management & Research,24100,0,24100
"Scott, Rick",(R),Gruss & Co,23900,0,23900
"Scott, Rick",(R),Keewin Real Property Co,23700,0,23700
"Scott, Rick",(R),"Cole, Scott & Kissane",23500,0,23500
"Scott, Rick",(R),Ferber Co,23300,0,23300
"Scott, Rick",(R),Koch Industries,22900,17500,5400
"Scott, Rick",(R),BGR Group,22810,6210,16600
"Scott, Rick",(R),FedEx Corp,22740,7500,15240
"Scott, Rick",(R),GL Homes of Florida,21600,0,21600
"Scott, Rick",(R),Station Casinos,21600,0,21600
"Scott, Rick",(R),Deloitte LLP,21425,10000,11425
"Scott, Rick",(R),Dab Constructors,21200,0,21200
"Scott, Rick",(R),Great Point Partners,21200,0,21200
"Scott, Rick",(R),Nextgen Management,21200,0,21200
"Scott, Rick",(R),Global Credit Advisers,21000,0,21000
"Scott, Rick",(R),Hydrologic Distribution Co,21000,0,21000
"Scott, Rick",(R),Covelli Enterprises,20800,0,20800
"Scott, Rick",(R),Akerman LLP,20750,0,20750
"Scott, Rick",(R),Mayport Venture Partners LLC,20450,0,20450
"Scott, Rick",(R),CSX Corp,19700,15000,4700
"Scott, Rick",(R),Truist Financial,19475,10000,9475
"Scott, Rick",(R),Omnicom Group,19400,0,19400
"Scott, Rick",(R),Comcast Corp,19200,15000,4200
"Scott, Rick",(R),JW Childs Assoc,18900,0,18900
"Scott, Rick",(R),Humana Inc,18800,10000,8800
"Scott, Rick",(R),First Republic Bank,18700,0,18700
"Scott, Rick",(R),Strand Partners,18700,0,18700
"Scott, Rick",(R),Copart Inc,18600,5000,13600
"Scott, Rick",(R),Altria Group,18200,15000,3200
"Scott, Rick",(R),Verizon Communications,18068,7000,11068
"Scott, Rick",(R),Holland & Knight,18050,2500,15550
"Scott, Rick",(R),AT&T Inc,17955,14000,3955
"Scott, Rick",(R),Hubbard Broadcasting,17950,0,17950
"Scott, Rick",(R),NCR Corp,17900,0,17900
"Scott, Rick",(R),Acadia Healthcare,17775,5000,12775
"Scott, Rick",(R),JM Family Enterprises,17650,15400,2250
"Scott, Rick",(R),Wells Fargo,17246,0,17246
"Scott, Rick",(R),Assured Partners Inc,16700,0,16700
"Scott, Rick",(R),Miller Strategies,16600,0,16600
"Scott, Rick",(R),Apollo Global Management,16500,15000,1500
"Scott, Rick",(R),Hopkins Pharmacy,16400,0,16400
"Scott, Rick",(R),Charles Schwab Corp,16205,0,16205
"Scott, Rick",(R),Alliance Coal,16200,0,16200
"Scott, Rick",(R),Anderson Columbia Co,16200,0,16200
"Scott, Rick",(R),Digestive & Liver Center of Florida,16200,0,16200
"Scott, Rick",(R),Fresh Start Produce Sales,16200,0,16200
"Scott, Rick",(R),Heritage Insurance,16200,0,16200
"Scott, Rick",(R),Jennmar Corp,16200,0,16200
"Scott, Rick",(R),Johnsonville Sausage,16200,0,16200
"Scott, Rick",(R),Mountaire Corp,16200,0,16200
"Scott, Rick",(R),Rex Lumber Co,16200,0,16200
"Scott, Rick",(R),Vecellio Group,16200,0,16200
"Scott, Rick",(R),American Bankers Assn,16050,15000,1050
"Scott, Rick",(R),Bainbridge Companies,16000,0,16000
"Scott, Rick",(R),Bay Fabrication,16000,0,16000
"Scott, Rick",(R),Fresenius Medical Care,16000,0,16000
"Scott, Rick",(R),Probity International,16000,0,16000
"Scott, Rick",(R),Rail Management Corp,16000,0,16000
"Scott, Rick",(R),US Travel Assn,16000,10000,6000
"Scott, Rick",(R),UnitedHealth Group,15900,10000,5900
"Scott, Rick",(R),Southern Glazer's Wine & Spirits,15650,8800,6850
"Scott, Rick",(R),Codina Partners,15600,0,15600
"Scott, Rick",(R),Holiday Inns,15600,0,15600
"Scott, Rick",(R),Ls Energia,15600,0,15600
"Scott, Rick",(R),Route One Investment,15600,0,15600
"Scott, Rick",(R),Devon Energy,15400,10000,5400
"Scott, Rick",(R),WW Gay Mechanical Contractor,15400,0,15400
"Scott, Rick",(R),L3Harris Technologies,15211,10000,5211
"Scott, Tim",(R),Votesane PAC,221000,0,221000
"Scott, Tim",(R),Capital Group Companies,143265,40500,102765
"Scott, Tim",(R),Dominion Energy,112054,36500,75554
"Scott, Tim",(R),"Nelson, Mullins et al",81420,5000,76420
"Scott, Tim",(R),AFLAC Inc,72050,32500,39550
"Scott, Tim",(R),Penn Mutual Life Insurance,69700,2500,67200
"Scott, Tim",(R),Prudential Financial,65575,31000,34575
"Scott, Tim",(R),Boeing Co,53179,25500,27679
"Scott, Tim",(R),Goldman Sachs,52775,23000,29775
"Scott, Tim",(R),Comcast Corp,51447,31500,19947
"Scott, Tim",(R),Blackstone Group,50841,6000,44841
"Scott, Tim",(R),PNC Financial Services,50292,49650,642
"Scott, Tim",(R),New York Life Insurance,47020,40000,7020
"Scott, Tim",(R),UBS AG,46700,40000,6700
"Scott, Tim",(R),FedEx Corp,44685,41000,3685
"Scott, Tim",(R),Amgen Inc,43770,33500,10270
"Scott, Tim",(R),National Assn of Realtors,42525,42000,525
"Scott, Tim",(R),Microsoft Corp,41845,20500,21345
"Scott, Tim",(R),Citigroup Inc,41170,13500,27670
"Scott, Tim",(R),Pfizer Inc,40273,39000,1273
"Scott, Tim",(R),Capital One Financial,40170,40000,170
"Scott, Tim",(R),Mortgage Bankers Assn,40000,40000,0
"Scott, Tim",(R),National Assn of Real Estate Investment Trusts,40000,40000,0
"Scott, Tim",(R),National Multifamily Housing Council,40000,40000,0
"Scott, Tim",(R),Abbott Laboratories,38710,37500,1210
"Scott, Tim",(R),Deloitte LLP,38358,35000,3358
"Scott, Tim",(R),Honeywell International,38308,37500,808
"Scott, Tim",(R),CSX Corp,37570,37500,70
"Scott, Tim",(R),American Bankers Assn,37550,37500,50
"Scott, Tim",(R),Club for Growth,37425,0,37425
"Scott, Tim",(R),Massachusetts Mutual Life Insurance,36590,36500,90
"Scott, Tim",(R),CVS Health,35263,33000,2263
"Scott, Tim",(R),American Dental Assn,35000,35000,0
"Scott, Tim",(R),Northrop Grumman,34838,32500,2338
"Scott, Tim",(R),PricewaterhouseCoopers,34785,34000,785
"Scott, Tim",(R),Northwestern Mutual,33665,30000,3665
"Scott, Tim",(R),UnitedHealth Group,33473,26000,7473
"Scott, Tim",(R),Wells Fargo,33384,19500,13884
"Scott, Tim",(R),Cigna Corp,32629,31500,1129
"Scott, Tim",(R),National Assn of Convenience Stores,32500,32500,0
"Scott, Tim",(R),Humanscale Corp,32300,0,32300
"Scott, Tim",(R),Sanofi,32020,26500,5520
"Scott, Tim",(R),America's Credit Unions,32000,32000,0
"Scott, Tim",(R),Independent Community Bankers of America,32000,32000,0
"Scott, Tim",(R),Independent Insurance Agents & Brokers of America,31750,31000,750
"Scott, Tim",(R),Berkshire Hathaway,31671,29000,2671
"Scott, Tim",(R),AmerisourceBergen Corp,31275,30000,1275
"Scott, Tim",(R),Lockheed Martin,31257,29500,1757
"Scott, Tim",(R),General Dynamics,31230,30000,1230
"Scott, Tim",(R),Koch Industries,30825,20000,10825
"Scott, Tim",(R),TIAA,30500,29500,1000
"Scott, Tim",(R),Duke Energy,30350,30000,350
"Scott, Tim",(R),Merck & Co,30345,30000,345
"Scott, Tim",(R),Blue Cross/Blue Shield,30313,26500,3813
"Scott, Tim",(R),Humana Inc,30245,30000,245
"Scott, Tim",(R),MetLife Inc,30115,30000,115
"Scott, Tim",(R),American Institute of CPAs,29999,29999,0
"Scott, Tim",(R),Grupo Salinas,29800,21500,8300
"Scott, Tim",(R),Roche Holdings,29655,29500,155
"Scott, Tim",(R),Pacific Life Insurance,29025,27500,1525
"Scott, Tim",(R),Allstate Insurance,28140,21500,6640
"Scott, Tim",(R),Walmart Inc,28113,25500,2613
"Scott, Tim",(R),NorPAC,28060,0,28060
"Scott, Tim",(R),Amway/Alticor Inc,28015,1000,27015
"Scott, Tim",(R),Aiken Electric Cooperative,28000,28000,0
"Scott, Tim",(R),Blessey Marine Service,27800,15000,12800
"Scott, Tim",(R),Hartford Financial Services,27750,25500,2250
"Scott, Tim",(R),American Hotel & Lodging Assn,27500,27500,0
"Scott, Tim",(R),JW Childs Assoc,27000,0,27000
"Scott, Tim",(R),Koch Inc,26297,20000,6297
"Scott, Tim",(R),AT&T Inc,26232,18500,7732
"Scott, Tim",(R),American Council of Life Insurers,25800,23000,2800
"Scott, Tim",(R),General Motors,25625,25000,625
"Scott, Tim",(R),Royal Bank of Canada,25000,8500,16500
"Scott, Tim",(R),Wine & Spirits Wholesalers of America,24999,24999,0
"Scott, Tim",(R),National Apartment Assn,24900,24900,0
"Scott, Tim",(R),Regions Financial,24593,24500,93
"Scott, Tim",(R),American Express,24505,24500,5
"Scott, Tim",(R),Council of Insurance Agents & Brokers,24500,24500,0
"Scott, Tim",(R),Investment Co Institute,24500,24500,0
"Scott, Tim",(R),Novogradac & Co,24400,0,24400
"Scott, Tim",(R),United Parcel Service,24340,22500,1840
"Scott, Tim",(R),Navient Corp,23625,23500,125
"Scott, Tim",(R),Home Depot,23539,21500,2039
"Scott, Tim",(R),FMR Corp,23500,23500,0
"Scott, Tim",(R),McKesson Corp,23230,23000,230
"Scott, Tim",(R),DaVita Inc,23150,22000,1150
"Scott, Tim",(R),American Land Title Assn,23000,23000,0
"Scott, Tim",(R),Altria Group,22570,22500,70
"Scott, Tim",(R),National Beer Wholesalers Assn,22500,22500,0
"Scott, Tim",(R),Miller Strategies,22400,0,22400
"Scott, Tim",(R),Google Inc,22090,22000,90
"Scott, Tim",(R),Toyota Corp,22000,0,22000
"Scott, Tim",(R),Eli Lilly & Co,21800,16000,5800
"Scott, Tim",(R),McDermott International,21600,21000,600
"Scott, Tim",(R),JPMorgan Chase & Co,21219,19000,2219
"Scott, Tim",(R),LPL Financial,21124,20999,125
"Scott, Tim",(R),"Brownstein, Hyatt et al",21100,5000,16100
"Scott, Tim",(R),Fierce Government Relations,21000,0,21000
"Scott, Tim",(R),Ernst & Young,20895,17000,3895
"Shaheen, Jeanne",(D),EMILY's List,169416,0,169416
"Shaheen, Jeanne",(D),Capital Group Companies,73622,10000,63622
"Shaheen, Jeanne",(D),Dartmouth College,68577,0,68577
"Shaheen, Jeanne",(D),BAE Systems,65552,38500,27052
"Shaheen, Jeanne",(D),University of New Hampshire,62177,0,62177
"Shaheen, Jeanne",(D),Fidelity Investments,56501,32500,24001
"Shaheen, Jeanne",(D),Votesane PAC,55500,0,55500
"Shaheen, Jeanne",(D),Beacon Companies,54400,0,54400
"Shaheen, Jeanne",(D),Microsoft Corp,49919,29500,20419
"Shaheen, Jeanne",(D),Centene Corp,47928,23500,24428
"Shaheen, Jeanne",(D),Harvard University,47257,0,47257
"Shaheen, Jeanne",(D),Blue Cross/Blue Shield,46112,38500,7612
"Shaheen, Jeanne",(D),State of New Hampshire,45497,0,45497
"Shaheen, Jeanne",(D),Honeywell International,45118,39000,6118
"Shaheen, Jeanne",(D),Comcast Corp,45077,22500,22577
"Shaheen, Jeanne",(D),National Multifamily Housing Council,41500,36500,5000
"Shaheen, Jeanne",(D),Northrop Grumman,41451,40000,1451
"Shaheen, Jeanne",(D),Sierra Nevada Corp,40210,21000,19210
"Shaheen, Jeanne",(D),Democracy Engine,36941,0,36941
"Shaheen, Jeanne",(D),JStreetPAC,36058,1070,34988
"Shaheen, Jeanne",(D),Raytheon Technologies,35787,21000,14787
"Shaheen, Jeanne",(D),General Atomics,35654,21000,14654
"Shaheen, Jeanne",(D),Anheuser-Busch,35375,35000,375
"Shaheen, Jeanne",(D),University of California,34769,0,34769
"Shaheen, Jeanne",(D),US Government,34658,0,34658
"Shaheen, Jeanne",(D),General Dynamics,33041,30000,3041
"Shaheen, Jeanne",(D),L3Harris Technologies,30745,30000,745
"Shaheen, Jeanne",(D),UnitedHealth Group,30590,22500,8090
"Shaheen, Jeanne",(D),Deloitte LLP,30385,25000,5385
"Shaheen, Jeanne",(D),National Assn of Letter Carriers,30190,30000,190
"Shaheen, Jeanne",(D),UBS AG,30053,30000,53
"Shaheen, Jeanne",(D),RTX Corp,29618,29000,618
"Shaheen, Jeanne",(D),Dartmouth-Hitchcock Medical Center,28086,0,28086
"Shaheen, Jeanne",(D),Mortgage Bankers Assn,27625,27500,125
"Shaheen, Jeanne",(D),Ropes & Gray,26907,0,26907
"Shaheen, Jeanne",(D),DaVita Inc,26753,15000,11753
"Shaheen, Jeanne",(D),Independent Community Bankers of America,26035,26000,35
"Shaheen, Jeanne",(D),Liberty Mutual,25771,21500,4271
"Shaheen, Jeanne",(D),American Hotel & Lodging Assn,25025,25000,25
"Shaheen, Jeanne",(D),Operating Engineers Union,25000,20000,5000
"Shaheen, Jeanne",(D),"Sheet Metal, Air, Rail & Transportation Union",25000,25000,0
"Shaheen, Jeanne",(D),SpaceX,24300,19000,5300
"Shaheen, Jeanne",(D),Clark Hill PLC,24000,5500,18500
"Shaheen, Jeanne",(D),Stanford University,23604,0,23604
"Shaheen, Jeanne",(D),iHeartMedia Inc,23550,23500,50
"Shaheen, Jeanne",(D),Mass General Brigham,22689,0,22689
"Shaheen, Jeanne",(D),International Paper,22515,22500,15
"Shaheen, Jeanne",(D),"Kleiner, Perkins et al",22400,0,22400
"Shaheen, Jeanne",(D),General Electric,21904,17500,4404
"Shaheen, Jeanne",(D),League of Conservation Voters,21626,4943,16683
"Shaheen, Jeanne",(D),NCTA The Internet & Television Assn,21500,21500,0
"Shaheen, Jeanne",(D),Alphabet Inc,21478,10000,11478
"Shaheen, Jeanne",(D),Anthem Inc,21449,15000,6449
"Shaheen, Jeanne",(D),Hewlett Packard Enterprise,21317,18500,2817
"Shaheen, Jeanne",(D),CVS Health,21090,9000,12090
"Shaheen, Jeanne",(D),Meredith Bay,20800,0,20800
"Shaheen, Jeanne",(D),Massachusetts Institute of Technology,20568,0,20568
"Shaheen, Jeanne",(D),Bain Capital,20325,0,20325
"Shaheen, Jeanne",(D),NextEra Energy,20305,20000,305
"Shaheen, Jeanne",(D),"Brownstein, Hyatt et al",20235,8500,11735
"Shaheen, Jeanne",(D),DLA Piper,20150,7500,12650
"Shaheen, Jeanne",(D),National Assn of Realtors,20044,20000,44
"Shaheen, Jeanne",(D),International Assn of Fire Fighters,20000,20000,0
"Shaheen, Jeanne",(D),National Fisheries Institute,20000,20000,0
"Shaheen, Jeanne",(D),AT&T Inc,19924,10000,9924
"Shaheen, Jeanne",(D),Walt Disney Co,19917,0,19917
"Shaheen, Jeanne",(D),National Assn of Broadcasters,19252,18000,1252
"Shaheen, Jeanne",(D),Masimo Corp,19000,5000,14000
"Shaheen, Jeanne",(D),"Akin, Gump et al",18783,3375,15408
"Shaheen, Jeanne",(D),American Bankers Assn,18750,18500,250
"Shaheen, Jeanne",(D),Lockheed Martin,18704,17500,1204
"Shaheen, Jeanne",(D),Tufts University,18683,0,18683
"Shaheen, Jeanne",(D),Charter Communications,18537,18500,37
"Shaheen, Jeanne",(D),Facebook Inc,18041,7500,10541
"Shaheen, Jeanne",(D),Citizens Financial Group,18010,10000,8010
"Shaheen, Jeanne",(D),Forbes Tate Partners,17600,0,17600
"Shaheen, Jeanne",(D),Laborers Union,17505,17500,5
"Shaheen, Jeanne",(D),Bloomberg LP,17218,0,17218
"Shaheen, Jeanne",(D),Capitol Counsel,17200,0,17200
"Shaheen, Jeanne",(D),Avenue Solutions,17145,0,17145
"Shaheen, Jeanne",(D),Cognosante LLC,17100,0,17100
"Shaheen, Jeanne",(D),Warburg Pincus,16829,2800,14029
"Shaheen, Jeanne",(D),Chartwell Hotels,16800,0,16800
"Shaheen, Jeanne",(D),Wells Fargo,16053,3500,12553
"Shaheen, Jeanne",(D),Holland & Knight,15935,12500,3435
"Shaheen, Jeanne",(D),Pfizer Inc,15767,15000,767
"Shaheen, Jeanne",(D),Goldman Sachs,15650,5000,10650
"Shaheen, Jeanne",(D),State of California,15587,0,15587
"Shaheen, Jeanne",(D),GE Aerospace,15400,15000,400
"Shaheen, Jeanne",(D),Motley Rice LLC,15323,0,15323
"Shaheen, Jeanne",(D),Service Employees International Union,15281,10000,5281
"Shaheen, Jeanne",(D),Fresenius Medical Care,15135,15000,135
"Shaheen, Jeanne",(D),Shaheen & Gordon,15125,0,15125
"Shaheen, Jeanne",(D),Granite Values,15000,10000,5000
"Shaheen, Jeanne",(D),Investment Co Institute,15000,15000,0
"Shaheen, Jeanne",(D),Motor City PAC,15000,10000,5000
"Shaheen, Jeanne",(D),National Assn of Health Underwriters,15000,15000,0
"Shaheen, Jeanne",(D),Poet LLC,15000,15000,0
"Shaheen, Jeanne",(D),Marriott International,14963,13500,1463
"Shaheen, Jeanne",(D),Walmart Inc,14903,14000,903
"Shelby, Richard C",(R),Lockheed Martin,143450,36000,107450
"Shelby, Richard C",(R),Boeing Co,126000,22500,103500
"Shelby, Richard C",(R),Collazo Enterprises,110000,0,110000
"Shelby, Richard C",(R),Truist Financial,83650,39000,44650
"Shelby, Richard C",(R),PNC Financial Services,81500,52500,29000
"Shelby, Richard C",(R),Apollo Global Management,78200,0,78200
"Shelby, Richard C",(R),General Dynamics,78000,35000,43000
"Shelby, Richard C",(R),FedEx Corp,77600,41000,36600
"Shelby, Richard C",(R),Great Southern Wood Preserving,75000,0,75000
"Shelby, Richard C",(R),Radiance Technologies,70000,15000,55000
"Shelby, Richard C",(R),Leidos Inc,65000,45000,20000
"Shelby, Richard C",(R),Citadel LLC,62000,0,62000
"Shelby, Richard C",(R),Torch Technologies,61600,10000,51600
"Shelby, Richard C",(R),MetLife Inc,60700,17000,43700
"Shelby, Richard C",(R),Franklin L Haney Co,57500,0,57500
"Shelby, Richard C",(R),Frontier Technology,57000,0,57000
"Shelby, Richard C",(R),Breland Homes,55000,0,55000
"Shelby, Richard C",(R),Goldman Sachs,52800,11000,41800
"Shelby, Richard C",(R),Southern Co,49200,36000,13200
"Shelby, Richard C",(R),Huntington Ingalls Industries,47500,32500,15000
"Shelby, Richard C",(R),US Bancorp,46800,24500,22300
"Shelby, Richard C",(R),Signature Bank,44050,0,44050
"Shelby, Richard C",(R),Honeywell International,44000,24000,20000
"Shelby, Richard C",(R),Northrop Grumman,43000,43000,0
"Shelby, Richard C",(R),Mortgage Bankers Assn,41500,40000,1500
"Shelby, Richard C",(R),AFLAC Inc,41000,30000,11000
"Shelby, Richard C",(R),Fidelity Investments,40650,12000,28650
"Shelby, Richard C",(R),Sierra Nevada Corp,40400,20000,20400
"Shelby, Richard C",(R),Home Depot,40000,40000,0
"Shelby, Richard C",(R),Jim Wilson & Assoc,40000,0,40000
"Shelby, Richard C",(R),General Atomics,39200,22500,16700
"Shelby, Richard C",(R),National Assn of Realtors,39000,39000,0
"Shelby, Richard C",(R),Sullivan & Cromwell,39000,0,39000
"Shelby, Richard C",(R),Total System Services,38000,5000,33000
"Shelby, Richard C",(R),Deloitte LLP,36000,35000,1000
"Shelby, Richard C",(R),ClearPath Foundation,35000,0,35000
"Shelby, Richard C",(R),Parsons Corp,35000,35000,0
"Shelby, Richard C",(R),Peopletec Inc,34000,0,34000
"Shelby, Richard C",(R),RTX Corp,33000,33000,0
"Shelby, Richard C",(R),Dynamis Inc,32500,0,32500
"Shelby, Richard C",(R),Delta Air Lines,32200,25000,7200
"Shelby, Richard C",(R),American Express,31500,7000,24500
"Shelby, Richard C",(R),Dese Research,30000,0,30000
"Shelby, Richard C",(R),"Morris, Haynes et al",30000,0,30000
"Shelby, Richard C",(R),Wine & Spirits Wholesalers of America,30000,30000,0
"Shelby, Richard C",(R),JPMorgan Chase & Co,29900,20000,9900
"Shelby, Richard C",(R),Raytheon Technologies,27600,15000,12600
"Shelby, Richard C",(R),AT&T Inc,27500,27500,0
"Shelby, Richard C",(R),Palantir Technologies,27500,0,27500
"Shelby, Richard C",(R),Regions Financial,27500,27500,0
"Shelby, Richard C",(R),Nasdaq Inc,27250,8000,19250
"Shelby, Richard C",(R),CME Group,26500,17000,9500
"Shelby, Richard C",(R),USAA,26500,14500,12000
"Shelby, Richard C",(R),Gray Research,26000,0,26000
"Shelby, Richard C",(R),RR&G LLC,25200,0,25200
"Shelby, Richard C",(R),General Electric,25100,16500,8600
"Shelby, Richard C",(R),Altria Group,25000,25000,0
"Shelby, Richard C",(R),Comcast Corp,25000,25000,0
"Shelby, Richard C",(R),CSX Corp,25000,25000,0
"Shelby, Richard C",(R),Kratos Defense & Security Solutions,25000,10000,15000
"Shelby, Richard C",(R),National Multifamily Housing Council,25000,25000,0
"Shelby, Richard C",(R),Norfolk Southern,25000,25000,0
"Shelby, Richard C",(R),PricewaterhouseCoopers,25000,25000,0
"Shelby, Richard C",(R),Prudential Financial,25000,25000,0
"Shelby, Richard C",(R),Quantum Research International,25000,0,25000
"Shelby, Richard C",(R),Union Pacific Corp,25000,25000,0
"Shelby, Richard C",(R),TCF Financial,24520,6000,18520
"Shelby, Richard C",(R),SAIC,24500,24000,500
"Shelby, Richard C",(R),"Paul, Weiss et al",23750,0,23750
"Shelby, Richard C",(R),State Street Corp,23350,4000,19350
"Shelby, Richard C",(R),Cubic Corp,23000,23000,0
"Shelby, Richard C",(R),National Apartment Assn,23000,23000,0
"Shelby, Richard C",(R),Wells Fargo,22800,9500,13300
"Shelby, Richard C",(R),Airbus Group,22500,16500,6000
"Shelby, Richard C",(R),American Bankers Assn,22000,20000,2000
"Shelby, Richard C",(R),BAE Systems,22000,22000,0
"Shelby, Richard C",(R),Experian,21500,19000,2500
"Shelby, Richard C",(R),American Trucking Assns,21000,21000,0
"Shelby, Richard C",(R),Berkshire Hathaway,21000,21000,0
"Shelby, Richard C",(R),National Cotton Council,21000,21000,0
"Shelby, Richard C",(R),Capital Group Companies,20000,20000,0
"Shelby, Richard C",(R),Capital One Financial,20000,20000,0
"Shelby, Richard C",(R),Crossroads Strategies,20000,0,20000
"Shelby, Richard C",(R),INFiN a Financial Services Alliance,20000,20000,0
"Shelby, Richard C",(R),Kord Technologies,20000,0,20000
"Shelby, Richard C",(R),National Assn of Home Builders,20000,20000,0
"Shelby, Richard C",(R),National Beer Wholesalers Assn,19500,19500,0
"Shelby, Richard C",(R),Scientific Research Corp,19500,0,19500
"Shelby, Richard C",(R),Van Scoyoc Assoc,19500,0,19500
"Shelby, Richard C",(R),Teledyne Technologies,19000,4000,15000
"Shelby, Richard C",(R),Blue Cross/Blue Shield,18000,10000,8000
"Shelby, Richard C",(R),Jacobs Engineering Group,17500,12500,5000
"Shelby, Richard C",(R),America's Credit Unions,17000,16000,1000
"Shelby, Richard C",(R),KPMG LLP,16500,15500,1000
"Shelby, Richard C",(R),Massachusetts Mutual Life Insurance,16000,16000,0
"Shelby, Richard C",(R),Aerojet Rocketdyne,15500,9500,6000
"Shelby, Richard C",(R),Allergan Inc,15000,15000,0
"Shelby, Richard C",(R),American Council of Life Insurers,15000,15000,0
"Shelby, Richard C",(R),American Hotel & Lodging Assn,15000,15000,0
"Shelby, Richard C",(R),Balch & Bingham,15000,15000,0
"Sinema, Kyrsten",(D),EMILY's List,405783,10000,395783
"Sinema, Kyrsten",(D),Democracy Engine,211304,0,211304
"Sinema, Kyrsten",(D),Votesane PAC,165650,0,165650
"Sinema, Kyrsten",(D),Arizona State University,105274,0,105274
"Sinema, Kyrsten",(D),Crescent Capital Group,104500,0,104500
"Sinema, Kyrsten",(D),Alphabet Inc,90393,15000,75393
"Sinema, Kyrsten",(D),DaVita Inc,85295,24500,60795
"Sinema, Kyrsten",(D),Blue Cross/Blue Shield,80776,25750,55026
"Sinema, Kyrsten",(D),Capital Group Companies,73600,26000,47600
"Sinema, Kyrsten",(D),University of California,71976,0,71976
"Sinema, Kyrsten",(D),American Airlines Group,63287,17000,46287
"Sinema, Kyrsten",(D),"Paul, Weiss et al",61650,0,61650
"Sinema, Kyrsten",(D),University of Arizona,60392,0,60392
"Sinema, Kyrsten",(D),Comcast Corp,56565,20000,36565
"Sinema, Kyrsten",(D),Pinnacle West Capital,52630,22000,30630
"Sinema, Kyrsten",(D),Blackstone Group,52350,0,52350
"Sinema, Kyrsten",(D),Snell & Wilmer,50940,0,50940
"Sinema, Kyrsten",(D),League of Conservation Voters,50398,9953,40445
"Sinema, Kyrsten",(D),Goldman Sachs,48850,17500,31350
"Sinema, Kyrsten",(D),Democratic Senatorial Campaign Cmte,47425,47400,25
"Sinema, Kyrsten",(D),CVS Health,46117,32500,13617
"Sinema, Kyrsten",(D),Lyft Inc,42720,0,42720
"Sinema, Kyrsten",(D),Charter Communications,41600,15000,26600
"Sinema, Kyrsten",(D),Salt River Project,39991,21000,18991
"Sinema, Kyrsten",(D),American Express,38933,18500,20433
"Sinema, Kyrsten",(D),UnitedHealth Group,38859,24500,14359
"Sinema, Kyrsten",(D),Walt Disney Co,38482,0,38482
"Sinema, Kyrsten",(D),Quicken Loans,38350,10000,28350
"Sinema, Kyrsten",(D),AT&T Inc,37223,16000,21223
"Sinema, Kyrsten",(D),Cox Enterprises,37200,23500,13700
"Sinema, Kyrsten",(D),Motley Rice LLC,37050,0,37050
"Sinema, Kyrsten",(D),Freedom Financial Network,35750,0,35750
"Sinema, Kyrsten",(D),Banner Health,35540,0,35540
"Sinema, Kyrsten",(D),PNC Financial Services,35247,33500,1747
"Sinema, Kyrsten",(D),Womencount PAC,35046,10,35036
"Sinema, Kyrsten",(D),Microsoft Corp,33542,9500,24042
"Sinema, Kyrsten",(D),National Air Traffic Controllers Assn,32500,32500,0
"Sinema, Kyrsten",(D),Harvard University,32396,0,32396
"Sinema, Kyrsten",(D),"Akin, Gump et al",31549,1500,30049
"Sinema, Kyrsten",(D),JUUL Labs,30700,7700,23000
"Sinema, Kyrsten",(D),Crescent Capital,30400,0,30400
"Sinema, Kyrsten",(D),National Venture Capital Assn,30000,30000,0
"Sinema, Kyrsten",(D),General Dynamics,29601,20000,9601
"Sinema, Kyrsten",(D),Wirtz Corp,29200,0,29200
"Sinema, Kyrsten",(D),JPMorgan Chase & Co,28370,20000,8370
"Sinema, Kyrsten",(D),Altria Group,27950,15000,12950
"Sinema, Kyrsten",(D),Anthem Inc,27833,26500,1333
"Sinema, Kyrsten",(D),Mortgage Bankers Assn,27750,22500,5250
"Sinema, Kyrsten",(D),"Wachtell, Lipton et al",27351,0,27351
"Sinema, Kyrsten",(D),Cigna Corp,27350,18500,8850
"Sinema, Kyrsten",(D),UBS AG,26750,23500,3250
"Sinema, Kyrsten",(D),DE Shaw & Co,26650,0,26650
"Sinema, Kyrsten",(D),Ernst & Young,26556,21000,5556
"Sinema, Kyrsten",(D),Intel Corp,26325,10000,16325
"Sinema, Kyrsten",(D),Honeywell International,25665,19500,6165
"Sinema, Kyrsten",(D),PricewaterhouseCoopers,25653,20000,5653
"Sinema, Kyrsten",(D),Visa Inc,25454,22500,2954
"Sinema, Kyrsten",(D),Fidelity Investments,25250,18500,6750
"Sinema, Kyrsten",(D),Pfizer Inc,25035,12500,12535
"Sinema, Kyrsten",(D),Council of Insurance Agents & Brokers,25000,25000,0
"Sinema, Kyrsten",(D),Perkins Coie,24406,0,24406
"Sinema, Kyrsten",(D),Highfields Capital Management,24350,0,24350
"Sinema, Kyrsten",(D),Amazon.com,24344,7500,16844
"Sinema, Kyrsten",(D),Rxr Realty,23900,0,23900
"Sinema, Kyrsten",(D),Stanford University,23783,0,23783
"Sinema, Kyrsten",(D),RTX Corp,23302,14500,8802
"Sinema, Kyrsten",(D),New York Life Insurance,23250,22500,750
"Sinema, Kyrsten",(D),Boeing Co,22929,14500,8429
"Sinema, Kyrsten",(D),Roche Holdings,22505,10000,12505
"Sinema, Kyrsten",(D),"Lieff, Cabraser et al",22500,0,22500
"Sinema, Kyrsten",(D),Duchossois Group,22400,0,22400
"Sinema, Kyrsten",(D),Facebook Inc,21735,0,21735
"Sinema, Kyrsten",(D),"Brownstein, Hyatt et al",21550,4000,17550
"Sinema, Kyrsten",(D),National Assn of Realtors,21525,20000,1525
"Sinema, Kyrsten",(D),Bank of New York Mellon,21200,13700,7500
"Sinema, Kyrsten",(D),Berkshire Hathaway,21178,19000,2178
"Sinema, Kyrsten",(D),Investment Co Institute,21000,20500,500
"Sinema, Kyrsten",(D),Otoe-Missouria Tribe,21000,0,21000
"Sinema, Kyrsten",(D),Capital Funding Group,20750,0,20750
"Sinema, Kyrsten",(D),Apple Inc,20508,0,20508
"Sinema, Kyrsten",(D),"Kazan, McClain et al",20500,0,20500
"Sinema, Kyrsten",(D),Southern Co,20433,18500,1933
"Sinema, Kyrsten",(D),Cornerstone Government Affairs,20399,0,20399
"Sinema, Kyrsten",(D),Wells Fargo,20326,7500,12826
"Sinema, Kyrsten",(D),United Food & Commercial Workers Union,20250,20000,250
"Sinema, Kyrsten",(D),Subject Matter,20100,0,20100
"Sinema, Kyrsten",(D),American Bankers Assn,20000,20000,0
"Sinema, Kyrsten",(D),Management & Training Corp,20000,20000,0
"Sinema, Kyrsten",(D),National Assn of Letter Carriers,20000,20000,0
"Sinema, Kyrsten",(D),Regions Financial,20000,20000,0
"Sinema, Kyrsten",(D),Broadcom Inc,19930,5500,14430
"Sinema, Kyrsten",(D),Deloitte LLP,19870,15000,4870
"Sinema, Kyrsten",(D),Air Line Pilots Assn,19750,19500,250
"Sinema, Kyrsten",(D),Forbes Tate Partners,19700,0,19700
"Sinema, Kyrsten",(D),Airlines for America,19400,12000,7400
"Sinema, Kyrsten",(D),Mayo Clinic,19400,0,19400
"Sinema, Kyrsten",(D),National Assn of Broadcasters,19250,15000,4250
"Sinema, Kyrsten",(D),American College of Emergency Physicians,19150,19000,150
"Sinema, Kyrsten",(D),Planned Parenthood,19025,9500,9525
"Sinema, Kyrsten",(D),US Acute Care Solutions,18750,15000,3750
"Smith, Tina",(D),EMILY's List,341693,20000,321693
"Smith, Tina",(D),University of Minnesota,229406,0,229406
"Smith, Tina",(D),Democracy Engine,219519,0,219519
"Smith, Tina",(D),State of Minnesota,98350,0,98350
"Smith, Tina",(D),Capital Group Companies,70025,27500,42525
"Smith, Tina",(D),Signature Bank,67675,0,67675
"Smith, Tina",(D),Lockridge Grindal Nauen Pllp,67618,13178,54440
"Smith, Tina",(D),US Bancorp,66885,35000,31885
"Smith, Tina",(D),Blue Cross/Blue Shield,66847,32000,34847
"Smith, Tina",(D),Wells Fargo,63316,25000,38316
"Smith, Tina",(D),General Mills,61840,20000,41840
"Smith, Tina",(D),Xcel Energy,60668,24500,36168
"Smith, Tina",(D),Mayo Clinic,60538,0,60538
"Smith, Tina",(D),UnitedHealth Group,58736,12500,46236
"Smith, Tina",(D),Medtronic Inc,58539,20000,38539
"Smith, Tina",(D),Dorsey & Whitney,58525,11000,47525
"Smith, Tina",(D),Comcast Corp,58026,27500,30526
"Smith, Tina",(D),Pohlad Companies,50425,0,50425
"Smith, Tina",(D),Ecolab Inc,49290,15000,34290
"Smith, Tina",(D),Best Buy,48773,24500,24273
"Smith, Tina",(D),Heartland Realty Investors,46900,0,46900
"Smith, Tina",(D),Allina Health,43058,0,43058
"Smith, Tina",(D),Cigna Corp,42230,37500,4730
"Smith, Tina",(D),Delta Air Lines,40868,15000,25868
"Smith, Tina",(D),Alphabet Inc,40729,10000,30729
"Smith, Tina",(D),Target Corp,36877,20500,16377
"Smith, Tina",(D),"Schwebel, Goetz & Sieben",36104,0,36104
"Smith, Tina",(D),3M Co,36012,10000,26012
"Smith, Tina",(D),Honeywell International,35800,32500,3300
"Smith, Tina",(D),"Faegre, Drinker et al",35505,15000,20505
"Smith, Tina",(D),Carpenters & Joiners Union,35100,35000,100
"Smith, Tina",(D),American Crystal Sugar,35005,35000,5
"Smith, Tina",(D),Farm Credit Council,35000,35000,0
"Smith, Tina",(D),Southern Minn Beet Sugar Co-Op,35000,35000,0
"Smith, Tina",(D),Microsoft Corp,34016,15500,18516
"Smith, Tina",(D),American Assn for Justice,33250,32500,750
"Smith, Tina",(D),Healthpartners Inc,32226,0,32226
"Smith, Tina",(D),Planned Parenthood,32000,17499,14501
"Smith, Tina",(D),Harvard University,30350,0,30350
"Smith, Tina",(D),Operating Engineers Union,30183,30000,183
"Smith, Tina",(D),Unity Avenue Assoc,30100,0,30100
"Smith, Tina",(D),Laborers Union,30010,30000,10
"Smith, Tina",(D),National Assn of Letter Carriers,30008,30000,8
"Smith, Tina",(D),People's Voice PAC,30000,20000,10000
"Smith, Tina",(D),National Education Assn,29553,20000,9553
"Smith, Tina",(D),League of Conservation Voters,28089,18999,9090
"Smith, Tina",(D),Goldman Sachs,27410,8500,18910
"Smith, Tina",(D),H&S Ventures,27000,0,27000
"Smith, Tina",(D),Service Employees International Union,26915,15000,11915
"Smith, Tina",(D),Land O'Lakes,26708,20000,6708
"Smith, Tina",(D),Motley Rice LLC,26500,0,26500
"Smith, Tina",(D),Cargill Inc,26309,13500,12809
"Smith, Tina",(D),WilmerHale LLP,26191,0,26191
"Smith, Tina",(D),International Assn of Fire Fighters,25000,25000,0
"Smith, Tina",(D),National Air Traffic Controllers Assn,25000,25000,0
"Smith, Tina",(D),Painters & Allied Trades Union,25000,25000,0
"Smith, Tina",(D),Poet LLC,25000,25000,0
"Smith, Tina",(D),IBM Corp,24864,0,24864
"Smith, Tina",(D),NAU Country Insurance,24250,0,24250
"Smith, Tina",(D),"Hennepin County, MN",23966,0,23966
"Smith, Tina",(D),United Parcel Service,22768,21000,1768
"Smith, Tina",(D),High Meadows Foundation,22715,0,22715
"Smith, Tina",(D),University of California,22560,0,22560
"Smith, Tina",(D),National Beer Wholesalers Assn,22500,22500,0
"Smith, Tina",(D),Robins Kaplan LLP,22483,4174,18309
"Smith, Tina",(D),Ernst & Young,22392,15000,7392
"Smith, Tina",(D),National Assn of Realtors,22086,22000,86
"Smith, Tina",(D),Metropolitan Corp,21600,0,21600
"Smith, Tina",(D),American Federation of Teachers,21354,21000,354
"Smith, Tina",(D),International Brotherhood of Electrical Workers,21076,20000,1076
"Smith, Tina",(D),US Government,20763,0,20763
"Smith, Tina",(D),United for A Strong America,20600,9400,11200
"Smith, Tina",(D),Council for a Livable World,20510,50,20460
"Smith, Tina",(D),American Federation of State/Cnty/Munic Employees,20415,20000,415
"Smith, Tina",(D),McKinsey & Co,20346,0,20346
"Smith, Tina",(D),United Steelworkers,20135,20000,135
"Smith, Tina",(D),Gray Plant Mooty,20130,1500,18630
"Smith, Tina",(D),Air Line Pilots Assn,20100,20000,100
"Smith, Tina",(D),American Optometric Assn,20024,20000,24
"Smith, Tina",(D),UNITE HERE,20020,20000,20
"Smith, Tina",(D),A New Direction PAC,20000,20000,0
"Smith, Tina",(D),All for Our Country,20000,20000,0
"Smith, Tina",(D),America Works,20000,20000,0
"Smith, Tina",(D),American Assn of Crop Insurers,20000,20000,0
"Smith, Tina",(D),Common Ground PAC,20000,20000,0
"Smith, Tina",(D),Common Sense Colorado,20000,20000,0
"Smith, Tina",(D),Follow the North Star Fund,20000,20000,0
"Smith, Tina",(D),Forward Together PAC,20000,20000,0
"Smith, Tina",(D),Fund for the Majority,20000,20000,0
"Smith, Tina",(D),Granite Values,20000,20000,0
"Smith, Tina",(D),Great Lakes PAC,20000,20000,0
"Smith, Tina",(D),Green Mountain PAC,20000,20000,0
"Smith, Tina",(D),Hawaii PAC,20000,20000,0
"Smith, Tina",(D),Impact (Schumer),20000,20000,0
"Smith, Tina",(D),Keystone America PAC,20000,20000,0
"Smith, Tina",(D),Lobo PAC,20000,20000,0
"Smith, Tina",(D),M-PAC,20000,20000,0
"Smith, Tina",(D),Mortgage Bankers Assn,20000,20000,0
"Smith, Tina",(D),Motor City PAC,20000,20000,0
"Smith, Tina",(D),Narragansett Bay PAC,20000,20000,0
"Stabenow, Debbie",(D),EMILY's List,208855,10000,198855
"Stabenow, Debbie",(D),University of Michigan,160186,0,160186
"Stabenow, Debbie",(D),Blue Cross/Blue Shield,127411,41500,85911
"Stabenow, Debbie",(D),Ford Motor Co,117669,41000,76669
"Stabenow, Debbie",(D),Votesane PAC,100975,0,100975
"Stabenow, Debbie",(D),DuPont Co,95397,21500,73897
"Stabenow, Debbie",(D),Democratic Senatorial Campaign Cmte,94800,94800,0
"Stabenow, Debbie",(D),DTE Energy,92271,36000,56271
"Stabenow, Debbie",(D),"Paul, Weiss et al",86675,0,86675
"Stabenow, Debbie",(D),Henry Ford Health System,73772,6000,67772
"Stabenow, Debbie",(D),Democracy Engine,70793,0,70793
"Stabenow, Debbie",(D),General Motors,70255,40000,30255
"Stabenow, Debbie",(D),American Hospital Assn,62050,40000,22050
"Stabenow, Debbie",(D),JPMorgan Chase & Co,62033,36000,26033
"Stabenow, Debbie",(D),CMS Energy,59391,36500,22891
"Stabenow, Debbie",(D),General Dynamics,59313,41000,18313
"Stabenow, Debbie",(D),Goldman Sachs,56995,13000,43995
"Stabenow, Debbie",(D),Quicken Loans,52136,5000,47136
"Stabenow, Debbie",(D),Farm Credit Council,46000,46000,0
"Stabenow, Debbie",(D),Citigroup Inc,45996,14000,31996
"Stabenow, Debbie",(D),Delta Air Lines,44846,35000,9846
"Stabenow, Debbie",(D),Wirtz Corp,44500,0,44500
"Stabenow, Debbie",(D),America's Credit Unions,44000,44000,0
"Stabenow, Debbie",(D),Michigan State University,43883,0,43883
"Stabenow, Debbie",(D),Dow Inc,43880,20000,23880
"Stabenow, Debbie",(D),Delta Dental Plans Assn,43601,10000,33601
"Stabenow, Debbie",(D),UBS Americas,43000,40000,3000
"Stabenow, Debbie",(D),NorPAC,42500,0,42500
"Stabenow, Debbie",(D),Fortis Inc,41145,20000,21145
"Stabenow, Debbie",(D),TCF Financial,41050,5000,36050
"Stabenow, Debbie",(D),Sterling Group,40500,0,40500
"Stabenow, Debbie",(D),International Brotherhood of Electrical Workers,40075,40000,75
"Stabenow, Debbie",(D),Honeywell International,40000,40000,0
"Stabenow, Debbie",(D),National Rural Electric Cooperative Assn,40000,40000,0
"Stabenow, Debbie",(D),Alphabet Inc,39346,10000,29346
"Stabenow, Debbie",(D),National Education Assn,39321,35000,4321
"Stabenow, Debbie",(D),Western Michigan University,38687,0,38687
"Stabenow, Debbie",(D),National Multifamily Housing Council,38500,38500,0
"Stabenow, Debbie",(D),Match-E-Be-Nash-She-Wish Band Pottawatomi Indians,38100,0,38100
"Stabenow, Debbie",(D),Liberty Partners Group,37566,0,37566
"Stabenow, Debbie",(D),National Assn of Real Estate Investment Trusts,37500,37500,0
"Stabenow, Debbie",(D),Womencount PAC,37133,20,37113
"Stabenow, Debbie",(D),Bayer AG,36800,16500,20300
"Stabenow, Debbie",(D),CME Group,36150,36000,150
"Stabenow, Debbie",(D),Centene Corp,36063,17500,18563
"Stabenow, Debbie",(D),Tenet Healthcare,35435,11000,24435
"Stabenow, Debbie",(D),Air Line Pilots Assn,35030,35000,30
"Stabenow, Debbie",(D),Mortgage Bankers Assn,35000,35000,0
"Stabenow, Debbie",(D),National Assn of Realtors,35000,35000,0
"Stabenow, Debbie",(D),National Beer Wholesalers Assn,35000,35000,0
"Stabenow, Debbie",(D),Poet LLC,35000,25000,10000
"Stabenow, Debbie",(D),United Auto Workers,34570,30000,4570
"Stabenow, Debbie",(D),American Health Care Assn,34300,30000,4300
"Stabenow, Debbie",(D),Comcast Corp,33882,32500,1382
"Stabenow, Debbie",(D),Blackstone Group,33700,0,33700
"Stabenow, Debbie",(D),Amazon.com,33021,15000,18021
"Stabenow, Debbie",(D),BlackRock Inc,33000,10000,23000
"Stabenow, Debbie",(D),Deloitte LLP,32605,22500,10105
"Stabenow, Debbie",(D),Jackson National Life Insurance,32525,31500,1025
"Stabenow, Debbie",(D),Dykema Gossett,32210,28500,3710
"Stabenow, Debbie",(D),Thrivent Financial,31500,31500,0
"Stabenow, Debbie",(D),General Electric,31215,13500,17715
"Stabenow, Debbie",(D),Coca-Cola Co,31150,14500,16650
"Stabenow, Debbie",(D),AT&T Inc,31101,27000,4101
"Stabenow, Debbie",(D),American Society for Radiation Oncology,31000,31000,0
"Stabenow, Debbie",(D),Palace Sports & Entertainment,30918,0,30918
"Stabenow, Debbie",(D),Carpenters & Joiners Union,30000,30000,0
"Stabenow, Debbie",(D),Growth Energy,30000,30000,0
"Stabenow, Debbie",(D),Nexcare Health Systems,28900,0,28900
"Stabenow, Debbie",(D),Alzheimer's Assn,27500,17500,10000
"Stabenow, Debbie",(D),American Crystal Sugar,27500,27500,0
"Stabenow, Debbie",(D),Laborers Union,27500,27500,0
"Stabenow, Debbie",(D),New York Life Insurance,27500,27500,0
"Stabenow, Debbie",(D),Sullivan & Cromwell,27425,0,27425
"Stabenow, Debbie",(D),"Miller, Canfield et al",27050,21000,6050
"Stabenow, Debbie",(D),Microsoft Corp,26093,15500,10593
"Stabenow, Debbie",(D),Finseca,26000,26000,0
"Stabenow, Debbie",(D),National Milk Producers Federation,26000,25000,1000
"Stabenow, Debbie",(D),"Sheet Metal, Air, Rail & Transportation Union",26000,26000,0
"Stabenow, Debbie",(D),Credit Suisse Group,25930,20000,5930
"Stabenow, Debbie",(D),American Institute of CPAs,25500,24000,1500
"Stabenow, Debbie",(D),FC Compassus,25500,25500,0
"Stabenow, Debbie",(D),Penske Corp,25400,0,25400
"Stabenow, Debbie",(D),Sun Communities,25400,0,25400
"Stabenow, Debbie",(D),Flagstar Bank,25284,21000,4284
"Stabenow, Debbie",(D),BASF Corp,25150,25000,150
"Stabenow, Debbie",(D),CVS Health,25128,22000,3128
"Stabenow, Debbie",(D),American Assn for Justice,25000,25000,0
"Stabenow, Debbie",(D),National Assn of Letter Carriers,25000,25000,0
"Stabenow, Debbie",(D),Operating Engineers Union,25000,25000,0
"Stabenow, Debbie",(D),Real Estate Roundtable,25000,25000,0
"Stabenow, Debbie",(D),United Fresh Produce Assn,25000,25000,0
"Stabenow, Debbie",(D),Renaissance Health Service,24997,24997,0
"Stabenow, Debbie",(D),State of Michigan,24710,0,24710
"Stabenow, Debbie",(D),Dentons,24150,14000,10150
"Stabenow, Debbie",(D),American Podiatric Medical Assn,24000,24000,0
"Stabenow, Debbie",(D),Employee-Owned S Corporations of America,24000,24000,0
"Stabenow, Debbie",(D),Wayne State University,23700,0,23700
"Stabenow, Debbie",(D),Intercontinental Exchange Inc,23500,22500,1000
"Stabenow, Debbie",(D),AFLAC Inc,23300,20000,3300
"Sullivan, Dan",(R),Rpm International,111193,10000,101193
"Sullivan, Dan",(R),Qurate Retail,82090,30000,52090
"Sullivan, Dan",(R),Trident Seafoods,64650,8400,56250
"Sullivan, Dan",(R),Carnival Corp,55600,12500,43100
"Sullivan, Dan",(R),Goldman Sachs,54100,1500,52600
"Sullivan, Dan",(R),Chugach Alaska,50350,32000,18350
"Sullivan, Dan",(R),Elliott Management,49700,0,49700
"Sullivan, Dan",(R),FedEx Corp,49437,36000,13437
"Sullivan, Dan",(R),"Calfee, Halter & Griswold",45800,0,45800
"Sullivan, Dan",(R),National Republican Senatorial Cmte,44700,44600,100
"Sullivan, Dan",(R),Atlas Air Worldwide,43925,31500,12425
"Sullivan, Dan",(R),General Atomics,41750,25000,16750
"Sullivan, Dan",(R),Armstrong Oil & Gas,41300,0,41300
"Sullivan, Dan",(R),Saltchuk,40950,10000,30950
"Sullivan, Dan",(R),Northrop Grumman,39767,39500,267
"Sullivan, Dan",(R),Berkshire Hathaway,39070,37500,1570
"Sullivan, Dan",(R),ConocoPhillips,37675,10000,27675
"Sullivan, Dan",(R),United Parcel Service,37142,36500,642
"Sullivan, Dan",(R),Hilcorp Energy,36999,0,36999
"Sullivan, Dan",(R),Royal Caribbean Group,36150,0,36150
"Sullivan, Dan",(R),Edison Chouest Offshore,35700,0,35700
"Sullivan, Dan",(R),Home Depot,35643,35000,643
"Sullivan, Dan",(R),Honeywell International,35306,35000,306
"Sullivan, Dan",(R),Norfolk Southern,35000,35000,0
"Sullivan, Dan",(R),Union Pacific Corp,35000,35000,0
"Sullivan, Dan",(R),AT&T Inc,33141,33000,141
"Sullivan, Dan",(R),Deloitte LLP,32788,30000,2788
"Sullivan, Dan",(R),Comcast Corp,32060,32000,60
"Sullivan, Dan",(R),General Dynamics,31625,31500,125
"Sullivan, Dan",(R),Wine & Spirits Wholesalers of America,31000,31000,0
"Sullivan, Dan",(R),Delta Air Lines,30925,30000,925
"Sullivan, Dan",(R),Northwest Alaska Native Assn,30750,30500,250
"Sullivan, Dan",(R),Citizens for Prosperity in America Today,30554,7554,23000
"Sullivan, Dan",(R),"Bryan, Cave et al",30500,30500,0
"Sullivan, Dan",(R),CSX Corp,30000,30000,0
"Sullivan, Dan",(R),Gci Communication,29554,0,29554
"Sullivan, Dan",(R),NCTA The Internet & Television Assn,29250,29000,250
"Sullivan, Dan",(R),Lynden Inc,28850,0,28850
"Sullivan, Dan",(R),Alaska Air Group,28290,17500,10790
"Sullivan, Dan",(R),Laborers Union,28000,28000,0
"Sullivan, Dan",(R),DISH Network,26400,18000,8400
"Sullivan, Dan",(R),"Paul, Weiss et al",25950,0,25950
"Sullivan, Dan",(R),Blackstone Group,25900,0,25900
"Sullivan, Dan",(R),Franklin Resources,25800,0,25800
"Sullivan, Dan",(R),Alaska Riverways Inc,25500,0,25500
"Sullivan, Dan",(R),Axiom International Investors,25400,0,25400
"Sullivan, Dan",(R),Pinnacle West Capital,25300,22500,2800
"Sullivan, Dan",(R),Cohen Group,25157,0,25157
"Sullivan, Dan",(R),Blank Rome LLP,25100,13500,11600
"Sullivan, Dan",(R),Capital Group Companies,25000,0,25000
"Sullivan, Dan",(R),State of Alaska,24839,0,24839
"Sullivan, Dan",(R),Aircraft Owners & Pilots Assn,24500,24500,0
"Sullivan, Dan",(R),Bering Straits Native Corp,24100,0,24100
"Sullivan, Dan",(R),Matson Inc,23875,8500,15375
"Sullivan, Dan",(R),Apollo Global Management,23410,0,23410
"Sullivan, Dan",(R),Polaris Industries,23300,6500,16800
"Sullivan, Dan",(R),Arctic Slope Native Assn,22620,10000,12620
"Sullivan, Dan",(R),Microsoft Corp,22600,16000,6600
"Sullivan, Dan",(R),General Motors,22575,21500,1075
"Sullivan, Dan",(R),Federal Aviation Admin Managers Assn,22500,22500,0
"Sullivan, Dan",(R),Verizon Communications,22375,22000,375
"Sullivan, Dan",(R),Carruth Management,21800,0,21800
"Sullivan, Dan",(R),Vigor Industrial,21600,15000,6600
"Sullivan, Dan",(R),Leach Capital,21200,0,21200
"Sullivan, Dan",(R),Huntington Ingalls Industries,20515,20500,15
"Sullivan, Dan",(R),Koch Inc,20510,20000,510
"Sullivan, Dan",(R),Cruise Lines International Assn,20500,19500,1000
"Sullivan, Dan",(R),LOCKHEED MARTIN,20144,20000,144
"Sullivan, Dan",(R),USAA,20005,20000,5
"Sullivan, Dan",(R),Anadarko Petroleum,20004,15000,5004
"Sullivan, Dan",(R),American Waterways Operators,20000,20000,0
"Sullivan, Dan",(R),Automotive Free International Trade PAC,20000,20000,0
"Sullivan, Dan",(R),Axiom Investors,20000,0,20000
"Sullivan, Dan",(R),Carpenters & Joiners Union,20000,20000,0
"Sullivan, Dan",(R),Century 21 Department Stores,20000,0,20000
"Sullivan, Dan",(R),Penco Properties,20000,0,20000
"Sullivan, Dan",(R),Freeman Spogli & Co,19600,0,19600
"Sullivan, Dan",(R),Facebook Inc,19510,8500,11010
"Sullivan, Dan",(R),National Assn of Broadcasters,19500,19500,0
"Sullivan, Dan",(R),RTX Corp,19000,19000,0
"Sullivan, Dan",(R),T-Mobile USA,18508,18500,8
"Sullivan, Dan",(R),Pacific Seafood Processors Assn,18500,11500,7000
"Sullivan, Dan",(R),Marathon Petroleum,18352,12500,5852
"Sullivan, Dan",(R),Pacific Seafood Group,18000,18000,0
"Sullivan, Dan",(R),Crossroads Strategies,17800,0,17800
"Sullivan, Dan",(R),Dentons,17375,9500,7875
"Sullivan, Dan",(R),Hunt Consolidated,17300,0,17300
"Sullivan, Dan",(R),American Bankers Assn,16800,15000,1800
"Sullivan, Dan",(R),Amway/Alticor Inc,16800,0,16800
"Sullivan, Dan",(R),Summit Partners,16600,0,16600
"Sullivan, Dan",(R),Blue Cross/Blue Shield,16575,15500,1075
"Sullivan, Dan",(R),American Tank & Fabricating,16500,0,16500
"Sullivan, Dan",(R),National Air Traffic Controllers Assn,16500,16500,0
"Sullivan, Dan",(R),NextEra Energy,16500,16500,0
"Sullivan, Dan",(R),BP,16330,7500,8830
"Sullivan, Dan",(R),Hohlt Group,16200,0,16200
"Sullivan, Dan",(R),National Multifamily Housing Council,16000,16000,0
"Sullivan, Dan",(R),Perella Weinberg Partners,15800,0,15800
"Sullivan, Dan",(R),Bridgecare Hospital,15600,0,15600
"Sullivan, Dan",(R),Google Inc,15400,12500,2900
"Tester, Jon",(D),League of Conservation Voters,523645,15946,507699
"Tester, Jon",(D),Goldman Sachs,171855,36000,135855
"Tester, Jon",(D),Capital Group Companies,106935,41500,65435
"Tester, Jon",(D),Berkshire Hathaway,94790,45000,49790
"Tester, Jon",(D),Comcast Corp,90965,40000,50965
"Tester, Jon",(D),Blue Cross/Blue Shield,89244,66000,23244
"Tester, Jon",(D),AT&T Inc,80662,31500,49162
"Tester, Jon",(D),Charter Communications,78938,41000,37938
"Tester, Jon",(D),"Paul, Weiss et al",70388,0,70388
"Tester, Jon",(D),MetLife Inc,69637,33000,36637
"Tester, Jon",(D),Microsoft Corp,67018,31000,36018
"Tester, Jon",(D),Votesane PAC,65750,0,65750
"Tester, Jon",(D),JPMorgan Chase & Co,65088,37500,27588
"Tester, Jon",(D),Visa Inc,64943,40000,24943
"Tester, Jon",(D),State of Montana,64394,0,64394
"Tester, Jon",(D),National Assn of Broadcasters,57000,38500,18500
"Tester, Jon",(D),Simmons Hanly Conroy,54550,0,54550
"Tester, Jon",(D),Montana State University,54545,0,54545
"Tester, Jon",(D),Fidelity Investments,54515,26500,28015
"Tester, Jon",(D),Citigroup Inc,54210,13500,40710
"Tester, Jon",(D),"Robbins, Geller et al",51400,0,51400
"Tester, Jon",(D),University of Montana,51207,0,51207
"Tester, Jon",(D),University of California,50749,0,50749
"Tester, Jon",(D),Walt Disney Co,50271,3500,46771
"Tester, Jon",(D),Alphabet Inc,48113,30000,18113
"Tester, Jon",(D),Deloitte LLP,47966,45000,2966
"Tester, Jon",(D),Delta Air Lines,47746,35000,12746
"Tester, Jon",(D),Democratic Senatorial Campaign Cmte,47400,47400,0
"Tester, Jon",(D),FedEx Corp,46424,40000,6424
"Tester, Jon",(D),"Brownstein, Hyatt et al",46410,12000,34410
"Tester, Jon",(D),America's Credit Unions,46250,46000,250
"Tester, Jon",(D),Blackstone Group,45810,0,45810
"Tester, Jon",(D),Motley Rice LLC,45400,0,45400
"Tester, Jon",(D),Pfizer Inc,45358,31000,14358
"Tester, Jon",(D),Northrop Grumman,44170,43000,1170
"Tester, Jon",(D),UnitedHealth Group,42838,35000,7838
"Tester, Jon",(D),American Bankers Assn,42650,40000,2650
"Tester, Jon",(D),Honeywell International,41191,35000,6191
"Tester, Jon",(D),Pechanga Band of Luiseno Mission Indians,40800,0,40800
"Tester, Jon",(D),International Brotherhood of Electrical Workers,40764,40000,764
"Tester, Jon",(D),Independent Community Bankers of America,40250,39000,1250
"Tester, Jon",(D),Merck & Co,40103,35000,5103
"Tester, Jon",(D),National Multifamily Housing Council,40000,40000,0
"Tester, Jon",(D),Altria Group,39211,36500,2711
"Tester, Jon",(D),National Assn of Realtors,39025,39000,25
"Tester, Jon",(D),United Parcel Service,38684,37000,1684
"Tester, Jon",(D),"Williams, Hart et al",37800,0,37800
"Tester, Jon",(D),Mortgage Bankers Assn,37500,37500,0
"Tester, Jon",(D),National Assn of Real Estate Investment Trusts,37500,37500,0
"Tester, Jon",(D),American Express,37401,37000,401
"Tester, Jon",(D),KPMG LLP,37213,36000,1213
"Tester, Jon",(D),Council for a Livable World,37049,200,36849
"Tester, Jon",(D),Laborers Union,37000,36500,500
"Tester, Jon",(D),US Bancorp,36470,32500,3970
"Tester, Jon",(D),Lockheed Martin,36296,32000,4296
"Tester, Jon",(D),General Dynamics,35868,35000,868
"Tester, Jon",(D),American Hospital Assn,35760,31500,4260
"Tester, Jon",(D),National Community Pharmacists Assn,35500,35000,500
"Tester, Jon",(D),Air Line Pilots Assn,35060,35000,60
"Tester, Jon",(D),National Assn of Letter Carriers,35000,35000,0
"Tester, Jon",(D),Bergman Draper Oslund,34900,0,34900
"Tester, Jon",(D),Sanofi,34509,33500,1009
"Tester, Jon",(D),Forbes Tate Partners,34000,0,34000
"Tester, Jon",(D),Stanford University,33612,0,33612
"Tester, Jon",(D),TCF Financial,33400,5000,28400
"Tester, Jon",(D),Subject Matter,33300,0,33300
"Tester, Jon",(D),General Motors,32887,23500,9387
"Tester, Jon",(D),DreamWorks SKG,32688,0,32688
"Tester, Jon",(D),Power Rogers LLP,32650,0,32650
"Tester, Jon",(D),American Trucking Assns,32500,32500,0
"Tester, Jon",(D),City National Bank,32410,0,32410
"Tester, Jon",(D),First Interstate BancSystem,32260,0,32260
"Tester, Jon",(D),Operating Engineers Union,32000,30000,2000
"Tester, Jon",(D),US Senate,31630,0,31630
"Tester, Jon",(D),NCTA The Internet & Television Assn,31536,30000,1536
"Tester, Jon",(D),American Assn for Justice,31500,31000,500
"Tester, Jon",(D),Tiber Creek Group,31400,0,31400
"Tester, Jon",(D),Verizon Communications,31374,30500,874
"Tester, Jon",(D),CSX Corp,30508,30000,508
"Tester, Jon",(D),Confederated Salish & Kootenai Tribes,30491,0,30491
"Tester, Jon",(D),USAA,30010,30000,10
"Tester, Jon",(D),Consumer Bankers Assn,30000,30000,0
"Tester, Jon",(D),National Beer Wholesalers Assn,30000,30000,0
"Tester, Jon",(D),"Kleiner, Perkins et al",29705,0,29705
"Tester, Jon",(D),Heartland Realty Investors,29700,0,29700
"Tester, Jon",(D),Capitol Counsel,29600,0,29600
"Tester, Jon",(D),Depository Trust & Clearing Corp,29500,29500,0
"Tester, Jon",(D),American Institute of CPAs,29100,29000,100
"Tester, Jon",(D),TIAA,29054,28000,1054
"Tester, Jon",(D),Billings Clinic,28884,0,28884
"Tester, Jon",(D),iHeartMedia Inc,28720,26000,2720
"Tester, Jon",(D),Shakopee Mdewakanton Sioux Community,28300,0,28300
"Tester, Jon",(D),American Physical Therapy Assn,28000,28000,0
"Tester, Jon",(D),American Property Casualty Insurance Assn,28000,28000,0
"Tester, Jon",(D),Union Pacific Corp,27555,27500,55
"Tester, Jon",(D),Norfolk Southern,27525,27500,25
"Tester, Jon",(D),Centerview Partners,27250,0,27250
"Tester, Jon",(D),"Newmark, Grubb et al",27025,0,27025
"Tester, Jon",(D),AFLAC Inc,27000,27000,0
"Tester, Jon",(D),Sares-Regis Group,27000,0,27000
"Thune, John",(R),Capital Group Companies,118900,41000,77900
"Thune, John",(R),NextEra Energy,99700,32000,67700
"Thune, John",(R),Blackstone Group,72700,5000,67700
"Thune, John",(R),Arizona Tile,68500,0,68500
"Thune, John",(R),Prudential Financial,68000,45000,23000
"Thune, John",(R),AT&T Inc,66005,45000,21005
"Thune, John",(R),Verizon Communications,65150,46000,19150
"Thune, John",(R),Northrop Grumman,62420,61500,920
"Thune, John",(R),Telephone & Data Systems Inc,56800,45000,11800
"Thune, John",(R),National Assn of Broadcasters,56500,41500,15000
"Thune, John",(R),Comcast Corp,56200,40000,16200
"Thune, John",(R),New York Life Insurance,50933,6000,44933
"Thune, John",(R),Schneider National,50600,32000,18600
"Thune, John",(R),Charter Communications,48500,46500,2000
"Thune, John",(R),NCTA The Internet & Television Assn,48500,40000,8500
"Thune, John",(R),Wiley Rein LLP,47950,0,47950
"Thune, John",(R),Pfizer Inc,47500,47500,0
"Thune, John",(R),National Assn of Realtors,46990,46990,0
"Thune, John",(R),Poet LLC,45400,27500,17900
"Thune, John",(R),Goldman Sachs,43100,32500,10600
"Thune, John",(R),FedEx Corp,42825,32000,10825
"Thune, John",(R),T-Mobile USA,42500,42500,0
"Thune, John",(R),Experian,42000,42000,0
"Thune, John",(R),Blue Cross/Blue Shield,41500,37500,4000
"Thune, John",(R),WPP plc,41350,2000,39350
"Thune, John",(R),1st Financial Bank USA,41000,0,41000
"Thune, John",(R),National Air Traffic Controllers Assn,41000,41000,0
"Thune, John",(R),Sanofi US,41000,41000,0
"Thune, John",(R),Norfolk Southern,40800,35000,5800
"Thune, John",(R),Honeywell International,40500,40500,0
"Thune, John",(R),Walmart Inc,40011,40000,11
"Thune, John",(R),Lockheed Martin,40005,40000,5
"Thune, John",(R),Automotive Free International Trade PAC,40000,40000,0
"Thune, John",(R),California Dairies Inc,40000,40000,0
"Thune, John",(R),Independent Insurance Agents & Brokers of America,40000,40000,0
"Thune, John",(R),National Assn of Convenience Stores,40000,40000,0
"Thune, John",(R),National Assn of Home Builders,40000,40000,0
"Thune, John",(R),National Beer Wholesalers Assn,40000,40000,0
"Thune, John",(R),National Multifamily Housing Council,40000,40000,0
"Thune, John",(R),Ford Motor Co,39775,39500,275
"Thune, John",(R),Walt Disney Co,39760,37500,2260
"Thune, John",(R),Berkshire Hathaway,39000,38500,500
"Thune, John",(R),RTX Corp,38000,38000,0
"Thune, John",(R),Fierce Government Relations,37700,0,37700
"Thune, John",(R),Air Line Pilots Assn,37500,37500,0
"Thune, John",(R),Altria Group,37500,37500,0
"Thune, John",(R),American Hospital Assn,37500,37500,0
"Thune, John",(R),Marathon Petroleum,37500,37500,0
"Thune, John",(R),United Parcel Service,37500,37500,0
"Thune, John",(R),Sinclair Broadcast Group,37250,7000,30250
"Thune, John",(R),Deloitte LLP,36332,35000,1332
"Thune, John",(R),US Travel Assn,36000,36000,0
"Thune, John",(R),Mortgage Bankers Assn,35500,35500,0
"Thune, John",(R),Truck Renting & Leasing Assn,35200,35200,0
"Thune, John",(R),Google Inc,35100,24500,10600
"Thune, John",(R),Abbott Laboratories,35000,35000,0
"Thune, John",(R),American Hotel & Lodging Assn,35000,35000,0
"Thune, John",(R),General Motors,35000,35000,0
"Thune, John",(R),Intel Corp,35000,35000,0
"Thune, John",(R),"National Stone, Sand & Gravel Assn",35000,35000,0
"Thune, John",(R),Capital One Financial,34000,34000,0
"Thune, John",(R),Council of Insurance Agents & Brokers,34000,34000,0
"Thune, John",(R),National Assn of Real Estate Investment Trusts,34000,34000,0
"Thune, John",(R),CGCN Group,33500,0,33500
"Thune, John",(R),National Assn of Mutual Insurance Companies,33500,33500,0
"Thune, John",(R),CSX Corp,33000,33000,0
"Thune, John",(R),Microsoft Corp,33000,30000,3000
"Thune, John",(R),National Venture Capital Assn,33000,33000,0
"Thune, John",(R),American Institute of CPAs,32500,32500,0
"Thune, John",(R),Merck & Co,32500,32500,0
"Thune, John",(R),National Apartment Assn,32500,32500,0
"Thune, John",(R),AFLAC Inc,31500,31500,0
"Thune, John",(R),Aircraft Owners & Pilots Assn,31500,31500,0
"Thune, John",(R),American Medical Assn,31500,31500,0
"Thune, John",(R),Northwest Excavating,31400,0,31400
"Thune, John",(R),iHeartMedia Inc,31000,31000,0
"Thune, John",(R),American Express,30900,30000,900
"Thune, John",(R),"Akin, Gump et al",30750,13000,17750
"Thune, John",(R),Home Depot,30525,30500,25
"Thune, John",(R),Southern Co,30505,30500,5
"Thune, John",(R),American Dental Assn,30500,30500,0
"Thune, John",(R),Independent Community Bankers of America,30500,30500,0
"Thune, John",(R),National Football League,30000,30000,0
"Thune, John",(R),Union Pacific Corp,30000,30000,0
"Thune, John",(R),USAA,30000,30000,0
"Thune, John",(R),Genesee & Wyoming,29800,21000,8800
"Thune, John",(R),Wine & Spirits Wholesalers of America,29499,29499,0
"Thune, John",(R),Sanford Health,29191,0,29191
"Thune, John",(R),Carnival Corp,29100,0,29100
"Thune, John",(R),Kansas City Southern,28799,19999,8800
"Thune, John",(R),Delta Air Lines,28625,28500,125
"Thune, John",(R),National Business Aviation Assn,28500,26000,2500
"Thune, John",(R),General Dynamics,28250,27000,1250
"Thune, John",(R),CVS Health,28050,27500,550
"Thune, John",(R),Amazon.com,27502,27500,2
"Thune, John",(R),American Academy of Dermatology Assn,27500,27500,0
"Thune, John",(R),American Waterways Operators,27500,27500,0
"Thune, John",(R),PricewaterhouseCoopers,27500,26500,1000
"Thune, John",(R),Target Corp,27500,27500,0
"Thune, John",(R),Mickelson & Co,27100,0,27100
"Tillis, Thom",(R),British American Tobacco,117125,50000,67125
"Tillis, Thom",(R),Truist Financial,104360,34000,70360
"Tillis, Thom",(R),Blackstone Group,93311,0,93311
"Tillis, Thom",(R),Duke Energy,87139,36000,51139
"Tillis, Thom",(R),Live Oak Bank,77950,10000,67950
"Tillis, Thom",(R),Fidelity Investments,74454,28500,45954
"Tillis, Thom",(R),Charter Communications,73866,30000,43866
"Tillis, Thom",(R),Goldman Sachs,70975,22500,48475
"Tillis, Thom",(R),Bank of America,68890,21000,47890
"Tillis, Thom",(R),Altria Group,68460,40000,28460
"Tillis, Thom",(R),Capital Group Companies,64149,25000,39149
"Tillis, Thom",(R),Wells Fargo,59869,15000,44869
"Tillis, Thom",(R),Comcast Corp,58169,40000,18169
"Tillis, Thom",(R),McGuireWoods LLP,56675,11000,45675
"Tillis, Thom",(R),UBS AG,55574,40000,15574
"Tillis, Thom",(R),AbbVie Inc,54459,32500,21959
"Tillis, Thom",(R),PricewaterhouseCoopers,53079,40000,13079
"Tillis, Thom",(R),Pfizer Inc,52090,29500,22590
"Tillis, Thom",(R),Quicken Loans,50925,10000,40925
"Tillis, Thom",(R),Northrop Grumman,48908,40000,8908
"Tillis, Thom",(R),Honeywell International,48185,40000,8185
"Tillis, Thom",(R),Prudential Financial,47596,22500,25096
"Tillis, Thom",(R),AT&T Inc,47585,43000,4585
"Tillis, Thom",(R),Amgen Inc,46935,29500,17435
"Tillis, Thom",(R),Elliott Management,46900,0,46900
"Tillis, Thom",(R),JPMorgan Chase & Co,46482,26000,20482
"Tillis, Thom",(R),Nucor Corp,46238,18000,28238
"Tillis, Thom",(R),Apollo Global Management,45691,2500,43191
"Tillis, Thom",(R),National Republican Senatorial Cmte,45262,44600,662
"Tillis, Thom",(R),United Parcel Service,45086,42000,3086
"Tillis, Thom",(R),Massachusetts Mutual Life Insurance,44900,22500,22400
"Tillis, Thom",(R),PNC Financial Services,43957,38000,5957
"Tillis, Thom",(R),Deloitte LLP,42533,40000,2533
"Tillis, Thom",(R),Home Depot,41955,40000,1955
"Tillis, Thom",(R),KPMG LLP,41141,40000,1141
"Tillis, Thom",(R),Facebook Inc,40617,12500,28117
"Tillis, Thom",(R),Merck & Co,40498,34000,6498
"Tillis, Thom",(R),ClearPath Foundation,40400,0,40400
"Tillis, Thom",(R),Regions Financial,39626,27500,12126
"Tillis, Thom",(R),Lockheed Martin,39472,30000,9472
"Tillis, Thom",(R),Charles Schwab Corp,39465,10000,29465
"Tillis, Thom",(R),American Bankers Assn,38995,35000,3995
"Tillis, Thom",(R),Provenance Hotels,38500,0,38500
"Tillis, Thom",(R),National Multifamily Housing Council,38000,38000,0
"Tillis, Thom",(R),Google Inc,37968,25000,12968
"Tillis, Thom",(R),Microsoft Corp,37924,31000,6924
"Tillis, Thom",(R),Berkshire Hathaway,37536,25000,12536
"Tillis, Thom",(R),American Institute of CPAs,37500,37500,0
"Tillis, Thom",(R),Dominion Energy,37136,21500,15636
"Tillis, Thom",(R),FedEx Corp,36986,25000,11986
"Tillis, Thom",(R),Ernst & Young,36268,30000,6268
"Tillis, Thom",(R),NCTA The Internet & Television Assn,36000,33000,3000
"Tillis, Thom",(R),Citizens Financial Group,35907,8000,27907
"Tillis, Thom",(R),CSX Corp,35300,35000,300
"Tillis, Thom",(R),Premier Inc,35136,15000,20136
"Tillis, Thom",(R),UnitedHealth Group,35053,28500,6553
"Tillis, Thom",(R),General Dynamics,35049,33500,1549
"Tillis, Thom",(R),American Hotel & Lodging Assn,35000,35000,0
"Tillis, Thom",(R),Brighthouse Financial,35000,0,35000
"Tillis, Thom",(R),California Dairies Inc,32500,32500,0
"Tillis, Thom",(R),Kirkland & Ellis,32300,0,32300
"Tillis, Thom",(R),Stedman West Interests,32000,0,32000
"Tillis, Thom",(R),Wine & Spirits Wholesalers of America,32000,32000,0
"Tillis, Thom",(R),Lm Restaurants,31800,0,31800
"Tillis, Thom",(R),Advance Auto Parts,31603,0,31603
"Tillis, Thom",(R),EmergeOrtho,31569,10000,21569
"Tillis, Thom",(R),"Akin, Gump et al",31130,13000,18130
"Tillis, Thom",(R),"Brownstein, Hyatt et al",31013,6000,25013
"Tillis, Thom",(R),Prestage Farms,30810,0,30810
"Tillis, Thom",(R),American Society of Anesthesiologists,30000,30000,0
"Tillis, Thom",(R),Mortgage Bankers Assn,30000,30000,0
"Tillis, Thom",(R),Genworth Financial,29850,13200,16650
"Tillis, Thom",(R),Roche Holdings,29675,22500,7175
"Tillis, Thom",(R),Delta Air Lines,29229,23500,5729
"Tillis, Thom",(R),BGR Group,29200,0,29200
"Tillis, Thom",(R),Outdoor Amusement Business Assn,29000,27500,1500
"Tillis, Thom",(R),National Assn of Realtors,28500,25000,3500
"Tillis, Thom",(R),ITG Brands,28475,20000,8475
"Tillis, Thom",(R),New York Life Insurance,27826,25000,2826
"Tillis, Thom",(R),National Assn of Real Estate Investment Trusts,27000,27000,0
"Tillis, Thom",(R),American Express,26195,26000,195
"Tillis, Thom",(R),Independent Community Bankers of America,26000,26000,0
"Tillis, Thom",(R),Lowe's Companies,25940,22500,3440
"Tillis, Thom",(R),Civic Service Inc,25400,0,25400
"Tillis, Thom",(R),Koch Industries,25315,20000,5315
"Tillis, Thom",(R),Randy Marion Automotive Group,25300,0,25300
"Tillis, Thom",(R),Walmart Inc,25270,18000,7270
"Tillis, Thom",(R),Southern Co,25255,25000,255
"Tillis, Thom",(R),Greenhill & Co,25200,0,25200
"Tillis, Thom",(R),Lovell Minnick Partners,25200,0,25200
"Tillis, Thom",(R),Amazon.com,25083,15000,10083
"Tillis, Thom",(R),Automotive Free International Trade PAC,25000,25000,0
"Tillis, Thom",(R),National Restaurant Assn,25000,25000,0
"Tillis, Thom",(R),Amscot Financial,24900,0,24900
"Tillis, Thom",(R),New Mountain Capital,24400,0,24400
"Tillis, Thom",(R),Anywhere Real Estate,24249,0,24249
"Tillis, Thom",(R),DISH Network,24200,13000,11200
"Tillis, Thom",(R),Capitol Counsel,24033,0,24033
"Tillis, Thom",(R),XPO Logistics,24015,0,24015
"Tillis, Thom",(R),Biogen,24000,21500,2500
"Toomey, Pat",(R),Club for Growth,401234,918,400316
"Toomey, Pat",(R),PNC Financial Services,162480,65000,97480
"Toomey, Pat",(R),Goldman Sachs,120929,36500,84429
"Toomey, Pat",(R),Comcast Corp,91675,37500,54175
"Toomey, Pat",(R),Select Medical Corp,84854,30000,54854
"Toomey, Pat",(R),PPL Corp,81572,32500,49072
"Toomey, Pat",(R),Capital Group Companies,80500,36000,44500
"Toomey, Pat",(R),Exelon Corp,78985,20500,58485
"Toomey, Pat",(R),Blackstone Group,77500,2500,75000
"Toomey, Pat",(R),Apollo Global Management,76000,0,76000
"Toomey, Pat",(R),Fidelity Investments,70150,16500,53650
"Toomey, Pat",(R),"Paul, Weiss et al",69300,0,69300
"Toomey, Pat",(R),Wells Fargo,67925,14500,53425
"Toomey, Pat",(R),Blue Cross/Blue Shield,66625,45500,21125
"Toomey, Pat",(R),Truist Financial,66050,33000,33050
"Toomey, Pat",(R),CVS Health,65310,39000,26310
"Toomey, Pat",(R),Pfizer Inc,57370,28000,29370
"Toomey, Pat",(R),AT&T Inc,57320,54000,3320
"Toomey, Pat",(R),MetLife Inc,56700,17000,39700
"Toomey, Pat",(R),Cigna Corp,56155,38000,18155
"Toomey, Pat",(R),JPMorgan Chase & Co,55425,32750,22675
"Toomey, Pat",(R),Federated Investors Inc,54650,4400,50250
"Toomey, Pat",(R),Elliott Management,54500,0,54500
"Toomey, Pat",(R),Bank of America,51435,10000,41435
"Toomey, Pat",(R),Duane Morris LLP,50955,29465,21490
"Toomey, Pat",(R),Massachusetts Mutual Life Insurance,50650,27500,23150
"Toomey, Pat",(R),American Bankers Assn,49225,40000,9225
"Toomey, Pat",(R),US Bancorp,48120,36000,12120
"Toomey, Pat",(R),Citigroup Inc,48100,17500,30600
"Toomey, Pat",(R),National Republican Senatorial Cmte,46800,46800,0
"Toomey, Pat",(R),Verizon Communications,46470,24000,22470
"Toomey, Pat",(R),Prudential Financial,46325,25000,21325
"Toomey, Pat",(R),Asplundh Tree Expert Co,45800,15000,30800
"Toomey, Pat",(R),KKR & Co,45625,4200,41425
"Toomey, Pat",(R),Penske Corp,45000,14000,31000
"Toomey, Pat",(R),Independent Insurance Agents & Brokers of America,43500,43500,0
"Toomey, Pat",(R),AQR Capital Management,43100,0,43100
"Toomey, Pat",(R),FS Investments,41550,17500,24050
"Toomey, Pat",(R),UnitedHealth Group,41250,22500,18750
"Toomey, Pat",(R),PricewaterhouseCoopers,41015,28000,13015
"Toomey, Pat",(R),American Institute of CPAs,40500,40500,0
"Toomey, Pat",(R),Wawa Inc,40380,14000,26380
"Toomey, Pat",(R),Wine & Spirits Wholesalers of America,39999,39999,0
"Toomey, Pat",(R),Mortgage Bankers Assn,39000,39000,0
"Toomey, Pat",(R),Morgan Stanley,38350,4000,34350
"Toomey, Pat",(R),National Assn of Realtors,38000,38000,0
"Toomey, Pat",(R),Victaulic,37799,0,37799
"Toomey, Pat",(R),Bank of New York Mellon,36670,15500,21170
"Toomey, Pat",(R),CrossAmerica Partners,36400,0,36400
"Toomey, Pat",(R),DaVita Inc,36225,21000,15225
"Toomey, Pat",(R),Chevron Corp,35900,12000,23900
"Toomey, Pat",(R),Deloitte LLP,35185,30000,5185
"Toomey, Pat",(R),Honeywell International,34785,33500,1285
"Toomey, Pat",(R),Fulton Financial,34600,7000,27600
"Toomey, Pat",(R),Sanofi,34525,33000,1525
"Toomey, Pat",(R),Universal Health Services,34466,5000,29466
"Toomey, Pat",(R),Northrop Grumman,34385,27500,6885
"Toomey, Pat",(R),FedEx Corp,33635,22500,11135
"Toomey, Pat",(R),Capital One Financial,33500,33500,0
"Toomey, Pat",(R),Credit Suisse Group,33400,25000,8400
"Toomey, Pat",(R),"Buchanan, Ingersoll & Rooney",33250,10000,23250
"Toomey, Pat",(R),Northwestern Mutual,32975,21500,11475
"Toomey, Pat",(R),Abbott Laboratories,32604,31019,1585
"Toomey, Pat",(R),AegisPAC,32500,0,32500
"Toomey, Pat",(R),KPMG LLP,32000,30500,1500
"Toomey, Pat",(R),Carlyle Group,31550,3000,28550
"Toomey, Pat",(R),National Assn of Real Estate Investment Trusts,31500,31500,0
"Toomey, Pat",(R),TCF Financial,31500,17500,14000
"Toomey, Pat",(R),Jones Day,31250,0,31250
"Toomey, Pat",(R),Madison Dearborn Partners,30300,0,30300
"Toomey, Pat",(R),Rothman Institute,30200,5400,24800
"Toomey, Pat",(R),Woodbranch Investments,30000,0,30000
"Toomey, Pat",(R),AmerisourceBergen Corp,29500,12500,17000
"Toomey, Pat",(R),Independent Community Bankers of America,29000,29000,0
"Toomey, Pat",(R),American Financial Group,28900,0,28900
"Toomey, Pat",(R),"Faegre, Drinker et al",28855,11000,17855
"Toomey, Pat",(R),American Land Title Assn,28500,28500,0
"Toomey, Pat",(R),Rite Aid Corp,28500,5000,23500
"Toomey, Pat",(R),Otis Eastern,28225,0,28225
"Toomey, Pat",(R),Quicken Loans,27400,0,27400
"Toomey, Pat",(R),Ellwood Group,27250,0,27250
"Toomey, Pat",(R),SEI Investments,27100,0,27100
"Toomey, Pat",(R),Chubb INA,26800,26800,0
"Toomey, Pat",(R),Paul Hastings LLP,26700,23500,3200
"Toomey, Pat",(R),Humana Inc,26500,25000,1500
"Toomey, Pat",(R),Charles Schwab Corp,26100,13000,13100
"Toomey, Pat",(R),S&P Global,26000,14000,12000
"Toomey, Pat",(R),Tristate Capital Bank,25795,0,25795
"Toomey, Pat",(R),UPMC Health System,25548,0,25548
"Toomey, Pat",(R),Koch Inc,25400,20000,5400
"Toomey, Pat",(R),AFLAC Inc,25000,25000,0
"Toomey, Pat",(R),National Multifamily Housing Council,25000,25000,0
"Toomey, Pat",(R),Valero Energy,25000,25000,0
"Toomey, Pat",(R),CDL Nuclear Technologies,24700,0,24700
"Toomey, Pat",(R),Koch Industries,24600,16500,8100
"Toomey, Pat",(R),Bentley Systems,24550,-5000,29550
"Toomey, Pat",(R),Atlas Air Worldwide,24500,24500,0
"Toomey, Pat",(R),Merck & Co,24430,23000,1430
"Toomey, Pat",(R),Berkshire Hathaway,23906,16500,7406
"Toomey, Pat",(R),Google Inc,23900,17000,6900
"Tuberville, Tommy",(R),Hometown Lenders,76300,0,76300
"Tuberville, Tommy",(R),Club for Growth,67896,0,67896
"Tuberville, Tommy",(R),Drummond Co,46900,18000,28900
"Tuberville, Tommy",(R),National Republican Senatorial Cmte,44600,44600,0
"Tuberville, Tommy",(R),Collazo Enterprises,39010,0,39010
"Tuberville, Tommy",(R),Wellborn Cabinet,33000,0,33000
"Tuberville, Tommy",(R),Radiance Technologies,29500,8000,21500
"Tuberville, Tommy",(R),Long Brothers LLC,27592,0,27592
"Tuberville, Tommy",(R),Home Depot,26383,15000,11383
"Tuberville, Tommy",(R),Breland Homes,25900,0,25900
"Tuberville, Tommy",(R),Willbrook Solutions,24700,0,24700
"Tuberville, Tommy",(R),Broadway Group,23900,0,23900
"Tuberville, Tommy",(R),Great Southern Wood Preserving,23600,0,23600
"Tuberville, Tommy",(R),Auburn University,23410,0,23410
"Tuberville, Tommy",(R),Trivector Services,23100,0,23100
"Tuberville, Tommy",(R),Proshot Concrete,22600,0,22600
"Tuberville, Tommy",(R),Smith's Inc of Dothan,21800,0,21800
"Tuberville, Tommy",(R),Ona Atlanta,21600,0,21600
"Tuberville, Tommy",(R),Woodland Homes,20850,0,20850
"Tuberville, Tommy",(R),Alabama Farmers Federation,20000,20000,0
"Tuberville, Tommy",(R),"Beasley, Allen et al",20000,0,20000
"Tuberville, Tommy",(R),Best Auto Sales,20000,0,20000
"Tuberville, Tommy",(R),D&J Enterprises,19800,0,19800
"Tuberville, Tommy",(R),Medical Properties Trust,19800,0,19800
"Tuberville, Tommy",(R),Conference America,19600,0,19600
"Tuberville, Tommy",(R),HighPoint Holdings,19050,0,19050
"Tuberville, Tommy",(R),Kelly Seed Co,18800,0,18800
"Tuberville, Tommy",(R),Ascent Residential,18600,0,18600
"Tuberville, Tommy",(R),US Peanut PAC,18500,18500,0
"Tuberville, Tommy",(R),Monte Sano Research,18450,0,18450
"Tuberville, Tommy",(R),Brasfield & Gorrie,18350,0,18350
"Tuberville, Tommy",(R),Southern Co,17860,15000,2860
"Tuberville, Tommy",(R),Flora-Bama Lounge,17800,0,17800
"Tuberville, Tommy",(R),Telapex Inc,17600,7300,10300
"Tuberville, Tommy",(R),Smith'S,17400,0,17400
"Tuberville, Tommy",(R),Southern States Bank,17330,0,17330
"Tuberville, Tommy",(R),Nucor Corp,17275,6000,11275
"Tuberville, Tommy",(R),Brett Robinson Real Estate,16800,0,16800
"Tuberville, Tommy",(R),Econo-Med Inc,16800,0,16800
"Tuberville, Tommy",(R),Protective Life Corp,16800,10000,6800
"Tuberville, Tommy",(R),Southern Waste Systems,16800,0,16800
"Tuberville, Tommy",(R),Stephens Inc,16400,5000,11400
"Tuberville, Tommy",(R),Caterpillar Inc,16210,5000,11210
"Tuberville, Tommy",(R),Colormasters,16000,0,16000
"Tuberville, Tommy",(R),McVantage Companies,16000,0,16000
"Tuberville, Tommy",(R),Stone Martin Builders,16000,0,16000
"Tuberville, Tommy",(R),Pepsi Cola Bottling Decatur,15600,0,15600
"Tuberville, Tommy",(R),Reed Contracting,15600,0,15600
"Tuberville, Tommy",(R),Blue Cross/Blue Shield,15186,15000,186
"Tuberville, Tommy",(R),FedEx Corp,15015,5000,10015
"Tuberville, Tommy",(R),"Maynard, Cooper & Gale",15000,12500,2500
"Tuberville, Tommy",(R),Responsibility & Freedom Work PAC,15000,15000,0
"Tuberville, Tommy",(R),Saiia Construction,14650,0,14650
"Tuberville, Tommy",(R),Aaa Cooper Transportation,14300,0,14300
"Tuberville, Tommy",(R),Publix Super Markets,14200,2500,11700
"Tuberville, Tommy",(R),Jim Wilson & Assoc,14100,0,14100
"Tuberville, Tommy",(R),Teledyne Technologies,14100,0,14100
"Tuberville, Tommy",(R),Ballard Partners,14000,0,14000
"Tuberville, Tommy",(R),Espy Co,14000,0,14000
"Tuberville, Tommy",(R),Kellett Investment Corp,14000,0,14000
"Tuberville, Tommy",(R),Kent Companies,14000,0,14000
"Tuberville, Tommy",(R),Quantum Energy Partners,14000,0,14000
"Tuberville, Tommy",(R),Ray Keller Lumber & Logging,13920,0,13920
"Tuberville, Tommy",(R),Trideum Corp,13900,0,13900
"Tuberville, Tommy",(R),Colonial Co (Alabama),13700,0,13700
"Tuberville, Tommy",(R),Whitaker Contracting,13700,0,13700
"Tuberville, Tommy",(R),Mitchell Grocery,13600,0,13600
"Tuberville, Tommy",(R),Dese Research,13500,0,13500
"Tuberville, Tommy",(R),Scientific Research Corp,13500,0,13500
"Tuberville, Tommy",(R),Community Health Systems,13400,5000,8400
"Tuberville, Tommy",(R),Southern Risk Services LLC,13004,0,13004
"Tuberville, Tommy",(R),Five Stones Research,12800,0,12800
"Tuberville, Tommy",(R),American Peanut Shellers Assn,12500,12500,0
"Tuberville, Tommy",(R),J&A Inc,12500,0,12500
"Tuberville, Tommy",(R),National Cotton Council,12500,12500,0
"Tuberville, Tommy",(R),State of Alabama,12420,0,12420
"Tuberville, Tommy",(R),Edison Chouest Offshore,12400,0,12400
"Tuberville, Tommy",(R),Bradley,12250,10000,2250
"Tuberville, Tommy",(R),Lesco Logistics,12200,0,12200
"Tuberville, Tommy",(R),National Distributing Co,12200,0,12200
"Tuberville, Tommy",(R),"City of Mobile, AL",12150,0,12150
"Tuberville, Tommy",(R),S3 Inc,11900,0,11900
"Tuberville, Tommy",(R),Balch & Bingham,11800,6000,5800
"Tuberville, Tommy",(R),Columbiana Tractor LLC,11600,0,11600
"Tuberville, Tommy",(R),AGM Consulting Services,11400,0,11400
"Tuberville, Tommy",(R),University of Alabama,11205,0,11205
"Tuberville, Tommy",(R),4m Research,11200,0,11200
"Tuberville, Tommy",(R),Bob Loquercio Auto Group,11200,0,11200
"Tuberville, Tommy",(R),Brumleu Investments LP,11200,0,11200
"Tuberville, Tommy",(R),Continental Pacific LLC,11200,0,11200
"Tuberville, Tommy",(R),Crowne Management,11200,0,11200
"Tuberville, Tommy",(R),Electronic Supply Co,11200,0,11200
"Tuberville, Tommy",(R),Franklin L Haney Co,11200,0,11200
"Tuberville, Tommy",(R),Nelson Brothers LLC,11200,0,11200
"Tuberville, Tommy",(R),P&S Transportation,11200,0,11200
"Tuberville, Tommy",(R),Premier Kings,11200,0,11200
"Tuberville, Tommy",(R),Rdv Corp,11200,0,11200
"Tuberville, Tommy",(R),Sequoia Capital,11200,0,11200
"Tuberville, Tommy",(R),Signature Utility Services LLC,11200,0,11200
"Tuberville, Tommy",(R),Sparks Energy,11200,0,11200
"Warner, Mark",(D),Dominion Energy,143362,27389,115973
"Warner, Mark",(D),"Wachtell, Lipton et al",102466,0,102466
"Warner, Mark",(D),Norfolk Southern,97377,30000,67377
"Warner, Mark",(D),Apollo Global Management,94553,5000,89553
"Warner, Mark",(D),Amazon.com,93021,40000,53021
"Warner, Mark",(D),Altria Group,89930,40000,49930
"Warner, Mark",(D),Goldman Sachs,89800,35000,54800
"Warner, Mark",(D),Columbia Capital,86198,0,86198
"Warner, Mark",(D),General Atomics,82500,25000,57500
"Warner, Mark",(D),Sullivan & Cromwell,79490,0,79490
"Warner, Mark",(D),Deloitte LLP,76717,35000,41717
"Warner, Mark",(D),Huntington Ingalls Industries,75763,40000,35763
"Warner, Mark",(D),McGuireWoods LLP,74174,25000,49174
"Warner, Mark",(D),Vista Equity Partners,70450,0,70450
"Warner, Mark",(D),Comcast Corp,70330,40000,30330
"Warner, Mark",(D),JPMorgan Chase & Co,69093,35000,34093
"Warner, Mark",(D),Prudential Financial,68500,40000,28500
"Warner, Mark",(D),"Akin, Gump et al",64956,5024,59932
"Warner, Mark",(D),Aloha Partners,61900,0,61900
"Warner, Mark",(D),Genworth Financial,61120,10000,51120
"Warner, Mark",(D),Covington & Burling,57821,0,57821
"Warner, Mark",(D),Northrop Grumman,53629,38500,15129
"Warner, Mark",(D),Visa Inc,53450,16000,37450
"Warner, Mark",(D),CVS Health,52814,28500,24314
"Warner, Mark",(D),Hilton Worldwide,51620,26000,25620
"Warner, Mark",(D),Verizon Communications,51111,20500,30611
"Warner, Mark",(D),Microsoft Corp,50212,27500,22712
"Warner, Mark",(D),Bloomberg Lp,49710,0,49710
"Warner, Mark",(D),Blue Cross/Blue Shield,48775,38500,10275
"Warner, Mark",(D),"Brownstein, Hyatt et al",48760,16500,32260
"Warner, Mark",(D),MasterCard Inc,47605,10000,37605
"Warner, Mark",(D),UBS AG,46950,40000,6950
"Warner, Mark",(D),Morgan Stanley,46245,7500,38745
"Warner, Mark",(D),Capital Group Companies,46100,21000,25100
"Warner, Mark",(D),"Paul, Weiss et al",43545,0,43545
"Warner, Mark",(D),Truist Financial,43295,16000,27295
"Warner, Mark",(D),Abbott Laboratories,42450,37000,5450
"Warner, Mark",(D),New Enterprise Assoc,41200,0,41200
"Warner, Mark",(D),Honeywell International,40250,40000,250
"Warner, Mark",(D),National Multifamily Housing Council,40000,40000,0
"Warner, Mark",(D),Investment Co Institute,39000,37500,1500
"Warner, Mark",(D),"Newmark, Grubb et al",38800,0,38800
"Warner, Mark",(D),Blackstone Group,38735,0,38735
"Warner, Mark",(D),American Seniors Housing Assn,38500,38500,0
"Warner, Mark",(D),National Air Traffic Controllers Assn,38500,38500,0
"Warner, Mark",(D),General Dynamics,38058,24500,13558
"Warner, Mark",(D),National Assn of Realtors,38000,35000,3000
"Warner, Mark",(D),Lockheed Martin,37458,35000,2458
"Warner, Mark",(D),Weinstein Properties,37200,0,37200
"Warner, Mark",(D),Berkshire Hathaway,37193,30000,7193
"Warner, Mark",(D),Merck & Co,37050,32000,5050
"Warner, Mark",(D),Massachusetts Mutual Life Insurance,37013,37000,13
"Warner, Mark",(D),National Assn of Real Estate Investment Trusts,37000,36000,1000
"Warner, Mark",(D),PricewaterhouseCoopers,36835,33000,3835
"Warner, Mark",(D),New York Life Insurance,36800,30000,6800
"Warner, Mark",(D),Mortgage Bankers Assn,36792,35500,1292
"Warner, Mark",(D),NCTA The Internet & Television Assn,36600,27500,9100
"Warner, Mark",(D),Sunset Digital Communications,36200,0,36200
"Warner, Mark",(D),Ernst & Young,35630,30000,5630
"Warner, Mark",(D),Baupost Group,35600,0,35600
"Warner, Mark",(D),DLA Piper,35370,11500,23870
"Warner, Mark",(D),Leidos Inc,35129,21000,14129
"Warner, Mark",(D),Royal Bank of Canada,34800,10000,24800
"Warner, Mark",(D),Union Square Ventures,34800,0,34800
"Warner, Mark",(D),AT&T Inc,34774,31000,3774
"Warner, Mark",(D),Accenture,34630,10500,24130
"Warner, Mark",(D),Pinnacle West Capital,34550,20000,14550
"Warner, Mark",(D),Lone Pine Capital,34400,0,34400
"Warner, Mark",(D),Kaufman & Canoles,34325,0,34325
"Warner, Mark",(D),IBM Corp,33517,0,33517
"Warner, Mark",(D),Independent Community Bankers of America,33500,33500,0
"Warner, Mark",(D),"Kleiner, Perkins et al",33200,0,33200
"Warner, Mark",(D),Emerson Collective,33100,0,33100
"Warner, Mark",(D),Commonwealth of Virginia,32738,0,32738
"Warner, Mark",(D),Marjorie Roberts Pc,32438,0,32438
"Warner, Mark",(D),Tellurian Inc,32100,15000,17100
"Warner, Mark",(D),Monumental Sports & Entertainment,32000,0,32000
"Warner, Mark",(D),Corning Inc,31679,25500,6179
"Warner, Mark",(D),Sidley Austin LLP,31183,5000,26183
"Warner, Mark",(D),1st Financial Bank USA,30800,0,30800
"Warner, Mark",(D),Windem,30800,0,30800
"Warner, Mark",(D),BlackRock Inc,30500,10000,20500
"Warner, Mark",(D),Cheniere Energy,30400,12500,17900
"Warner, Mark",(D),American Bankers Assn,30388,27000,3388
"Warner, Mark",(D),US Senate,30298,0,30298
"Warner, Mark",(D),Generation Investment Management,30100,0,30100
"Warner, Mark",(D),Pfizer Inc,30025,30000,25
"Warner, Mark",(D),CSX Corp,30000,30000,0
"Warner, Mark",(D),General Atlantic,29900,0,29900
"Warner, Mark",(D),Reed Smith LLP,29650,10500,19150
"Warner, Mark",(D),Carlyle Group,29560,0,29560
"Warner, Mark",(D),JBG Smith,29500,0,29500
"Warner, Mark",(D),Morrison & Foerster,29350,0,29350
"Warner, Mark",(D),Google Inc,29347,4700,24647
"Warner, Mark",(D),"Wilbanks, Smith & Thomas Asset Management",29200,0,29200
"Warner, Mark",(D),Ruben Companies,29100,0,29100
"Warner, Mark",(D),Pragmatics Inc,29050,12700,16350
"Warner, Mark",(D),American Healthcare LLC,28988,0,28988
"Warner, Mark",(D),"Kellogg, Hansen et al",28850,0,28850
"Warner, Mark",(D),DaVita Inc,28521,25000,3521
"Warnock, Raphael",(D),Alphabet Inc,581858,0,581858
"Warnock, Raphael",(D),University of California,521898,0,521898
"Warnock, Raphael",(D),JStreetPAC,399297,0,399297
"Warnock, Raphael",(D),Microsoft Corp,293125,0,293125
"Warnock, Raphael",(D),Democracy Engine,240785,0,240785
"Warnock, Raphael",(D),Emory University,201322,0,201322
"Warnock, Raphael",(D),Apple Inc,200839,0,200839
"Warnock, Raphael",(D),US Government,188425,0,188425
"Warnock, Raphael",(D),Kaiser Permanente,182405,0,182405
"Warnock, Raphael",(D),Stanford University,170749,0,170749
"Warnock, Raphael",(D),US Dept of Health & Human Services,169610,0,169610
"Warnock, Raphael",(D),Amazon.com,159162,0,159162
"Warnock, Raphael",(D),Harvard University,149515,0,149515
"Warnock, Raphael",(D),University of Washington,138835,0,138835
"Warnock, Raphael",(D),State of California,134087,0,134087
"Warnock, Raphael",(D),IBM Corp,132704,0,132704
"Warnock, Raphael",(D),"Paul, Weiss et al",125076,0,125076
"Warnock, Raphael",(D),Walt Disney Co,123515,0,123515
"Warnock, Raphael",(D),Comcast Corp,119784,0,119784
"Warnock, Raphael",(D),Columbia University,118994,0,118994
"Warnock, Raphael",(D),University of Maryland,112020,0,112020
"Warnock, Raphael",(D),Warner Brothers Discovery,111426,0,111426
"Warnock, Raphael",(D),Meta,109032,0,109032
"Warnock, Raphael",(D),City University of New York,108721,0,108721
"Warnock, Raphael",(D),Wilmerhale Llp,108094,0,108094
"Warnock, Raphael",(D),"City of New York, NY",102572,0,102572
"Warnock, Raphael",(D),US Dept of Veterans Affairs,101760,0,101760
"Warnock, Raphael",(D),University of Michigan,101316,0,101316
"Warnock, Raphael",(D),Massachusetts Institute of Technology,99346,0,99346
"Warnock, Raphael",(D),US Dept of State,90453,0,90453
"Warnock, Raphael",(D),Delta Air Lines,90036,0,90036
"Warnock, Raphael",(D),Capital Group Companies,90017,0,90017
"Warnock, Raphael",(D),Yale University,88566,0,88566
"Warnock, Raphael",(D),Oracle Corp,88440,0,88440
"Warnock, Raphael",(D),Mass General Brigham,88272,0,88272
"Warnock, Raphael",(D),New York University,86669,0,86669
"Warnock, Raphael",(D),US Dept of Defense,86592,0,86592
"Warnock, Raphael",(D),"Lieff, Cabraser et al",86062,0,86062
"Warnock, Raphael",(D),Duke University,82934,0,82934
"Warnock, Raphael",(D),Greenberg Traurig LLP,79916,5000,74916
"Warnock, Raphael",(D),Johns Hopkins University,78951,0,78951
"Warnock, Raphael",(D),University of Georgia,77840,0,77840
"Warnock, Raphael",(D),State University of New York,76269,0,76269
"Warnock, Raphael",(D),University of Texas,75925,0,75925
"Warnock, Raphael",(D),Blue Cross/Blue Shield,75534,0,75534
"Warnock, Raphael",(D),University of North Carolina,73216,0,73216
"Warnock, Raphael",(D),Wells Fargo,71361,0,71361
"Warnock, Raphael",(D),Kirkland & Ellis,70692,0,70692
"Warnock, Raphael",(D),Motley Rice LLC,70548,0,70548
"Warnock, Raphael",(D),Boeing Co,69751,0,69751
"Warnock, Raphael",(D),New Hampshire Georgia Victory Fund,69560,0,69560
"Warnock, Raphael",(D),Cornell University,67520,0,67520
"Warnock, Raphael",(D),California State University,66914,0,66914
"Warnock, Raphael",(D),University of Pennsylvania,66619,0,66619
"Warnock, Raphael",(D),JPMorgan Chase & Co,66182,0,66182
"Warnock, Raphael",(D),NVIDIA Corp,65219,0,65219
"Warnock, Raphael",(D),State of New York,64800,0,64800
"Warnock, Raphael",(D),US Dept of Energy,64247,0,64247
"Warnock, Raphael",(D),University of Chicago,63648,0,63648
"Warnock, Raphael",(D),King & Spalding,63582,2500,61082
"Warnock, Raphael",(D),Troutman Pepper,63579,0,63579
"Warnock, Raphael",(D),"Akin, Gump et al",63266,5000,58266
"Warnock, Raphael",(D),Rutgers University,62322,0,62322
"Warnock, Raphael",(D),University of Wisconsin,62216,0,62216
"Warnock, Raphael",(D),US Postal Service,62189,0,62189
"Warnock, Raphael",(D),University of Illinois,61941,0,61941
"Warnock, Raphael",(D),US Army,61099,0,61099
"Warnock, Raphael",(D),University of Southern California,59234,0,59234
"Warnock, Raphael",(D),Northwestern University,59004,0,59004
"Warnock, Raphael",(D),Georgetown University,57870,0,57870
"Warnock, Raphael",(D),Deloitte LLP,55829,0,55829
"Warnock, Raphael",(D),Boston University,55366,0,55366
"Warnock, Raphael",(D),National Amusements Inc,54752,0,54752
"Warnock, Raphael",(D),UnitedHealth Group,54654,0,54654
"Warnock, Raphael",(D),University of Minnesota,54117,0,54117
"Warnock, Raphael",(D),Sidley Austin LLP,52999,0,52999
"Warnock, Raphael",(D),Georgia Tech,51451,0,51451
"Warnock, Raphael",(D),Democratic Senatorial Campaign Cmte,51450,51200,250
"Warnock, Raphael",(D),Northrop Grumman,50472,0,50472
"Warnock, Raphael",(D),University of Colorado,50248,0,50248
"Warnock, Raphael",(D),Salesforce.com,50244,0,50244
"Warnock, Raphael",(D),"Simpson, Thacher & Bartlett",50151,0,50151
"Warnock, Raphael",(D),Accenture,50069,0,50069
"Warnock, Raphael",(D),"City & County of San Francisco, CA",50065,0,50065
"Warnock, Raphael",(D),AT&T Inc,49515,0,49515
"Warnock, Raphael",(D),Dentons,49379,0,49379
"Warnock, Raphael",(D),Latham & Watkins,48821,0,48821
"Warnock, Raphael",(D),Lockheed Martin,48563,0,48563
"Warnock, Raphael",(D),Bank of America,48150,0,48150
"Warnock, Raphael",(D),US Dept of Commerce,48097,0,48097
"Warnock, Raphael",(D),League of Conservation Voters,47239,9575,37664
"Warnock, Raphael",(D),NARAL Pro-Choice America,47208,15000,32208
"Warnock, Raphael",(D),Blackstone Group,46910,0,46910
"Warnock, Raphael",(D),US Environmental Protection Agency,46882,0,46882
"Warnock, Raphael",(D),Tufts University,46563,0,46563
"Warnock, Raphael",(D),Goldman Sachs,46350,0,46350
"Warnock, Raphael",(D),Cox Enterprises,46157,0,46157
"Warnock, Raphael",(D),US Navy,45624,0,45624
"Warnock, Raphael",(D),Home Depot,44100,0,44100
"Warnock, Raphael",(D),BlackRock Inc,43165,0,43165
"Warren, Elizabeth",(D),Emily's List,128682,5000,123682
"Warren, Elizabeth",(D),Harvard University,126214,0,126214
"Warren, Elizabeth",(D),University of California,113819,0,113819
"Warren, Elizabeth",(D),Womencount PAC,109512,3005,106507
"Warren, Elizabeth",(D),Alphabet Inc,66822,0,66822
"Warren, Elizabeth",(D),Massachusetts Institute of Technology,63057,0,63057
"Warren, Elizabeth",(D),Brown Rudnick LLP,60275,5000,55275
"Warren, Elizabeth",(D),University of Massachusetts,59145,0,59145
"Warren, Elizabeth",(D),Stanford University,48985,0,48985
"Warren, Elizabeth",(D),Boston University,44946,0,44946
"Warren, Elizabeth",(D),Mass General Brigham,44609,0,44609
"Warren, Elizabeth",(D),"Lieff, Cabraser et al",38500,0,38500
"Warren, Elizabeth",(D),Warner Brothers Discovery,37548,0,37548
"Warren, Elizabeth",(D),League of Conservation Voters,34235,31,34204
"Warren, Elizabeth",(D),City University of New York,33720,0,33720
"Warren, Elizabeth",(D),Democracy Engine,33426,0,33426
"Warren, Elizabeth",(D),University of Texas,32780,0,32780
"Warren, Elizabeth",(D),Commonwealth of Massachusetts,32056,0,32056
"Warren, Elizabeth",(D),Microsoft Corp,30659,0,30659
"Warren, Elizabeth",(D),University of Michigan,30262,0,30262
"Warren, Elizabeth",(D),State of California,30065,0,30065
"Warren, Elizabeth",(D),Comcast Corp,29639,0,29639
"Warren, Elizabeth",(D),Apple Inc,29517,0,29517
"Warren, Elizabeth",(D),University of Washington,28781,0,28781
"Warren, Elizabeth",(D),Berger & Montague,27291,0,27291
"Warren, Elizabeth",(D),Kaiser Permanente,26154,0,26154
"Warren, Elizabeth",(D),Yelp Inc,25970,0,25970
"Warren, Elizabeth",(D),Salesforce.Com,25472,0,25472
"Warren, Elizabeth",(D),Morgan Stanley,24767,0,24767
"Warren, Elizabeth",(D),Walt Disney Co,24557,0,24557
"Warren, Elizabeth",(D),Amazon.com,24420,0,24420
"Warren, Elizabeth",(D),California State University,24384,0,24384
"Warren, Elizabeth",(D),"Cotchett, Pitre & McCarthy",23900,0,23900
"Warren, Elizabeth",(D),Goulston & Storrs,23725,0,23725
"Warren, Elizabeth",(D),Blue Cross/Blue Shield,23451,0,23451
"Warren, Elizabeth",(D),IBM Corp,22967,0,22967
"Warren, Elizabeth",(D),University of Pennsylvania,22871,0,22871
"Warren, Elizabeth",(D),Baron & Budd,22525,0,22525
"Warren, Elizabeth",(D),Blue Haven Initiative,22400,0,22400
"Warren, Elizabeth",(D),Smith College,22173,0,22173
"Warren, Elizabeth",(D),Moveon.org,21939,5000,16939
"Warren, Elizabeth",(D),State University of New York,21912,0,21912
"Warren, Elizabeth",(D),Northeastern University,21620,0,21620
"Warren, Elizabeth",(D),Tufts University,20737,0,20737
"Warren, Elizabeth",(D),"City of New York, NY",20678,0,20678
"Warren, Elizabeth",(D),"Kazan, McClain et al",20230,0,20230
"Warren, Elizabeth",(D),Impact (Schumer),20000,20000,0
"Warren, Elizabeth",(D),Social Security Administration,19568,0,19568
"Warren, Elizabeth",(D),Amblin Partners,19116,0,19116
"Warren, Elizabeth",(D),Bain Capital,18839,0,18839
"Warren, Elizabeth",(D),US Government,18200,0,18200
"Warren, Elizabeth",(D),Columbia University,18016,0,18016
"Warren, Elizabeth",(D),National Education Assn,17460,10000,7460
"Warren, Elizabeth",(D),New York University,17243,0,17243
"Warren, Elizabeth",(D),J Street,17206,0,17206
"Warren, Elizabeth",(D),"Waters, Kraus & Paul",17200,0,17200
"Warren, Elizabeth",(D),US Dept of Veterans Affairs,17176,0,17176
"Warren, Elizabeth",(D),National Amusements Inc,16866,0,16866
"Warren, Elizabeth",(D),Yale University,16707,0,16707
"Warren, Elizabeth",(D),Johns Hopkins University,16589,0,16589
"Warren, Elizabeth",(D),Renaissance Technologies,16225,0,16225
"Warren, Elizabeth",(D),Ziffren Brittenham LLP,16200,0,16200
"Warren, Elizabeth",(D),University of Minnesota,16105,0,16105
"Warren, Elizabeth",(D),US Dept of Health & Human Services,15817,0,15817
"Warren, Elizabeth",(D),Anywhere Real Estate,15411,0,15411
"Warren, Elizabeth",(D),AT&T Inc,15325,0,15325
"Warren, Elizabeth",(D),Creative Artists Agency,15036,0,15036
"Warren, Elizabeth",(D),Lowenstein Sandler Llp,14335,0,14335
"Warren, Elizabeth",(D),Cornell University,14138,0,14138
"Warren, Elizabeth",(D),Cisco Systems,14018,0,14018
"Warren, Elizabeth",(D),University of Wisconsin,13873,0,13873
"Warren, Elizabeth",(D),US Postal Service,13665,0,13665
"Warren, Elizabeth",(D),Siemens AG,13601,0,13601
"Warren, Elizabeth",(D),Triumvirate Environmental,13600,0,13600
"Warren, Elizabeth",(D),New Boston Ventures,13500,0,13500
"Warren, Elizabeth",(D),Intel Corp,13458,0,13458
"Warren, Elizabeth",(D),University of Connecticut,13174,0,13174
"Warren, Elizabeth",(D),Service Employees International Union,13157,5000,8157
"Warren, Elizabeth",(D),Bayer AG,13033,0,13033
"Warren, Elizabeth",(D),University of North Carolina,12983,0,12983
"Warren, Elizabeth",(D),Oracle Corp,12952,0,12952
"Warren, Elizabeth",(D),Beth Israel Lahey Health,12906,0,12906
"Warren, Elizabeth",(D),Amtrak,12835,0,12835
"Warren, Elizabeth",(D),University of Illinois,12612,0,12612
"Warren, Elizabeth",(D),Alsop Louie Partners,12400,0,12400
"Warren, Elizabeth",(D),Northwestern University,12369,0,12369
"Warren, Elizabeth",(D),Planned Parenthood,12260,7,12253
"Warren, Elizabeth",(D),Analysis Group,12180,0,12180
"Warren, Elizabeth",(D),"City & County of San Francisco, CA",12142,0,12142
"Warren, Elizabeth",(D),"Kemnitzer, Barron & Krieg",11800,0,11800
"Warren, Elizabeth",(D),"Panish, Shea & Boyle",11800,0,11800
"Warren, Elizabeth",(D),Power Rogers LLP,11800,0,11800
"Warren, Elizabeth",(D),Vanderbilt University,11678,0,11678
"Warren, Elizabeth",(D),Michigan State University,11561,0,11561
"Warren, Elizabeth",(D),University of Maryland,11485,0,11485
"Warren, Elizabeth",(D),Heising-Simons Foundation,11200,0,11200
"Warren, Elizabeth",(D),State of New York,11049,0,11049
"Warren, Elizabeth",(D),Elevation Partners,11000,0,11000
"Warren, Elizabeth",(D),Ischemix,11000,0,11000
"Warren, Elizabeth",(D),Lichten & Liss-Riordan,11000,0,11000
"Whitehouse, Sheldon",(D),League of Conservation Voters,190261,21812,168449
"Whitehouse, Sheldon",(D),Democracy Engine,83038,0,83038
"Whitehouse, Sheldon",(D),Technology Crossover Ventures,51200,0,51200
"Whitehouse, Sheldon",(D),Aloha Partners,47900,0,47900
"Whitehouse, Sheldon",(D),American Assn for Justice,42500,40000,2500
"Whitehouse, Sheldon",(D),International Brotherhood of Electrical Workers,42265,38400,3865
"Whitehouse, Sheldon",(D),"Kleiner, Perkins et al",38900,0,38900
"Whitehouse, Sheldon",(D),CVS Health,36535,30000,6535
"Whitehouse, Sheldon",(D),Walt Disney Co,36210,12000,24210
"Whitehouse, Sheldon",(D),Centerbridge Partners,35400,0,35400
"Whitehouse, Sheldon",(D),National Beer Wholesalers Assn,35000,35000,0
"Whitehouse, Sheldon",(D),WilmerHale Llp,34839,0,34839
"Whitehouse, Sheldon",(D),"Sheet Metal, Air, Rail & Transportation Union",33500,33500,0
"Whitehouse, Sheldon",(D),Motley Rice LLC,33475,0,33475
"Whitehouse, Sheldon",(D),Comcast Corp,32660,17500,15160
"Whitehouse, Sheldon",(D),"Kazan, McClain et al",32300,0,32300
"Whitehouse, Sheldon",(D),Brown University,31582,0,31582
"Whitehouse, Sheldon",(D),Laborers Union,30000,30000,0
"Whitehouse, Sheldon",(D),Masimo Corp,29356,2206,27150
"Whitehouse, Sheldon",(D),PG&E Corp,29020,28770,250
"Whitehouse, Sheldon",(D),National Assn of Broadcasters,28000,28000,0
"Whitehouse, Sheldon",(D),DLA Piper,25700,21000,4700
"Whitehouse, Sheldon",(D),Microsoft Corp,25685,20000,5685
"Whitehouse, Sheldon",(D),Alkermes Inc,25400,15000,10400
"Whitehouse, Sheldon",(D),Bauman Foundation,25400,0,25400
"Whitehouse, Sheldon",(D),Hard Rock Cafe,25400,0,25400
"Whitehouse, Sheldon",(D),Summit Foundation,25300,0,25300
"Whitehouse, Sheldon",(D),Moelis & Co,25200,0,25200
"Whitehouse, Sheldon",(D),Eric M Kamerath & Assoc,25000,0,25000
"Whitehouse, Sheldon",(D),RTX Corp,24535,19500,5035
"Whitehouse, Sheldon",(D),Larkspur Management,24380,0,24380
"Whitehouse, Sheldon",(D),IBM Corp,23931,0,23931
"Whitehouse, Sheldon",(D),Seavey Organization,23700,0,23700
"Whitehouse, Sheldon",(D),Fay Law Group,23650,0,23650
"Whitehouse, Sheldon",(D),General Dynamics,23055,21000,2055
"Whitehouse, Sheldon",(D),JStreetPAC,22899,5000,17899
"Whitehouse, Sheldon",(D),Intellectual Ventures LLC,22450,21200,1250
"Whitehouse, Sheldon",(D),Korein Tillery LLC,21200,0,21200
"Whitehouse, Sheldon",(D),Lockheed Martin,21005,21000,5
"Whitehouse, Sheldon",(D),Emerson Collective,20800,0,20800
"Whitehouse, Sheldon",(D),Capitol City Group,20600,0,20600
"Whitehouse, Sheldon",(D),National Assn of Realtors,19890,19650,240
"Whitehouse, Sheldon",(D),B&D Holding Di Marco Drago e C Sapa,19875,7500,12375
"Whitehouse, Sheldon",(D),"Adler, Pollock & Sheehan",19650,0,19650
"Whitehouse, Sheldon",(D),University Otolaryngology,19300,0,19300
"Whitehouse, Sheldon",(D),March Brown LLC,19130,0,19130
"Whitehouse, Sheldon",(D),Mount Sinai Health System,18900,0,18900
"Whitehouse, Sheldon",(D),Cornish Assoc,18825,0,18825
"Whitehouse, Sheldon",(D),Ocean Champions,18630,11230,7400
"Whitehouse, Sheldon",(D),National Air Traffic Controllers Assn,18000,18000,0
"Whitehouse, Sheldon",(D),Power Rogers LLP,18000,0,18000
"Whitehouse, Sheldon",(D),Greenberg Traurig LLP,17900,9000,8900
"Whitehouse, Sheldon",(D),National Grid USA,17800,5500,12300
"Whitehouse, Sheldon",(D),Four Seasons Ventures,17600,0,17600
"Whitehouse, Sheldon",(D),Cardinal Health,17500,17500,0
"Whitehouse, Sheldon",(D),Cencora Inc,17500,17500,0
"Whitehouse, Sheldon",(D),Island Press,17250,0,17250
"Whitehouse, Sheldon",(D),Anbau Enterprises,16400,0,16400
"Whitehouse, Sheldon",(D),"Kellogg, Hansen et al",16400,0,16400
"Whitehouse, Sheldon",(D),DreamWorks SKG,16200,0,16200
"Whitehouse, Sheldon",(D),National Amusements Inc,16100,6000,10100
"Whitehouse, Sheldon",(D),DISH Network,15800,5000,10800
"Whitehouse, Sheldon",(D),Goldman Sachs,15800,0,15800
"Whitehouse, Sheldon",(D),Barr Foundation,15400,0,15400
"Whitehouse, Sheldon",(D),Pilot House Assoc,15400,0,15400
"Whitehouse, Sheldon",(D),American Dental Assn,15000,15000,0
"Whitehouse, Sheldon",(D),"Mandell, Boisclair & Mandell",15000,0,15000
"Whitehouse, Sheldon",(D),National Assn of Letter Carriers,15000,15000,0
"Whitehouse, Sheldon",(D),Operating Engineers Local 57,15000,15000,0
"Whitehouse, Sheldon",(D),State of Rhode Island,14865,0,14865
"Whitehouse, Sheldon",(D),Altshuler Berzon LLP,14700,0,14700
"Whitehouse, Sheldon",(D),West Marine,14650,0,14650
"Whitehouse, Sheldon",(D),"Chisholm, Chisholm & Kilpatrick",14525,0,14525
"Whitehouse, Sheldon",(D),Eleanor Briggs Phoenix Studio,14500,0,14500
"Whitehouse, Sheldon",(D),American Federation of State/Cnty/Munic Employees,14400,14400,0
"Whitehouse, Sheldon",(D),"Akin, Gump et al",14200,4700,9500
"Whitehouse, Sheldon",(D),ACF Property Management,13900,0,13900
"Whitehouse, Sheldon",(D),Forbes Tate Partners,13750,0,13750
"Whitehouse, Sheldon",(D),"Mandell, Schwartz & Boisclair",13600,0,13600
"Whitehouse, Sheldon",(D),Blue Cross/Blue Shield,13565,10000,3565
"Whitehouse, Sheldon",(D),"Halpern, Denny & Co",13500,0,13500
"Whitehouse, Sheldon",(D),National Education Assn,13450,9750,3700
"Whitehouse, Sheldon",(D),Ironworkers Union,13000,13000,0
"Whitehouse, Sheldon",(D),Painters & Allied Trades Union,13000,13000,0
"Whitehouse, Sheldon",(D),SAP America,13000,10500,2500
"Whitehouse, Sheldon",(D),Stone Canyon Industries,13000,0,13000
"Whitehouse, Sheldon",(D),Johnson Capital Partners,12900,0,12900
"Whitehouse, Sheldon",(D),Plumbers/Pipefitters Union,12800,12800,0
"Whitehouse, Sheldon",(D),Alphabet Inc,12704,8000,4704
"Whitehouse, Sheldon",(D),Susman Godfrey LLP,12612,0,12612
"Whitehouse, Sheldon",(D),International Alliance Theatrical Stage Employees,12500,12500,0
"Whitehouse, Sheldon",(D),Walmart Inc,12311,12000,311
"Whitehouse, Sheldon",(D),Brown Rudnick LLP,12250,0,12250
"Whitehouse, Sheldon",(D),American Federation of Teachers,12211,10000,2211
"Whitehouse, Sheldon",(D),Larkspur Services,12200,0,12200
"Whitehouse, Sheldon",(D),AT&T Inc,12066,6000,6066
"Whitehouse, Sheldon",(D),Broadcast Music Inc,12000,12000,0
"Whitehouse, Sheldon",(D),Salesforce.com,11800,0,11800
"Whitehouse, Sheldon",(D),"Pannone, Lopes et al",11650,0,11650
"Whitehouse, Sheldon",(D),Eugene Lee Inc,11550,0,11550
"Wicker, Roger",(R),Telapex Inc,126150,12500,113650
"Wicker, Roger",(R),BGR Group,123500,0,123500
"Wicker, Roger",(R),Berkshire Hathaway,74025,42500,31525
"Wicker, Roger",(R),National Assn of Broadcasters,68850,37500,31350
"Wicker, Roger",(R),Comcast Corp,53200,39000,14200
"Wicker, Roger",(R),Charter Communications,52800,27000,25800
"Wicker, Roger",(R),Huntington Ingalls Industries,51917,33500,18417
"Wicker, Roger",(R),General Atomics,49100,25000,24100
"Wicker, Roger",(R),Genesee & Wyoming,47100,20000,27100
"Wicker, Roger",(R),Northrop Grumman,46025,46000,25
"Wicker, Roger",(R),AT&T Inc,46000,45000,1000
"Wicker, Roger",(R),DISH Network,46000,29200,16800
"Wicker, Roger",(R),Verizon Communications,45700,42000,3700
"Wicker, Roger",(R),Sanderson Farms,43500,0,43500
"Wicker, Roger",(R),RTX Corp,43400,38000,5400
"Wicker, Roger",(R),Fresenius Medical Care,42000,3500,38500
"Wicker, Roger",(R),Air Line Pilots Assn,40000,40000,0
"Wicker, Roger",(R),CSX Corp,40000,40000,0
"Wicker, Roger",(R),National Multifamily Housing Council,40000,40000,0
"Wicker, Roger",(R),NCTA The Internet & Television Assn,40000,39000,1000
"Wicker, Roger",(R),Union Pacific Corp,40000,40000,0
"Wicker, Roger",(R),Ergon Inc,38600,0,38600
"Wicker, Roger",(R),T-Mobile USA,38500,38500,0
"Wicker, Roger",(R),UBS Americas,37700,35000,2700
"Wicker, Roger",(R),Entergy Corp,37575,34500,3075
"Wicker, Roger",(R),Honeywell International,37500,37500,0
"Wicker, Roger",(R),Deloitte LLP,35045,35000,45
"Wicker, Roger",(R),National Auto Dealers Assn,35000,35000,0
"Wicker, Roger",(R),Cubic Corp,34800,24000,10800
"Wicker, Roger",(R),Novocure Inc,34400,19500,14900
"Wicker, Roger",(R),Microsoft Corp,34200,31500,2700
"Wicker, Roger",(R),National Assn of Realtors,34000,34000,0
"Wicker, Roger",(R),Walt Disney Co,34000,34000,0
"Wicker, Roger",(R),Google Inc,33700,25000,8700
"Wicker, Roger",(R),Corelogic Inc,32700,15000,17700
"Wicker, Roger",(R),Edison Chouest Offshore,31200,0,31200
"Wicker, Roger",(R),Council of Insurance Agents & Brokers,31000,30000,1000
"Wicker, Roger",(R),NorPAC,30220,0,30220
"Wicker, Roger",(R),Pruet Oil,29629,0,29629
"Wicker, Roger",(R),Cox Enterprises,29000,24000,5000
"Wicker, Roger",(R),Granite Telecommunications,27900,0,27900
"Wicker, Roger",(R),Pan Am Equities,27900,0,27900
"Wicker, Roger",(R),Novogradac & Co,26600,0,26600
"Wicker, Roger",(R),Freedom Capital Partners,25400,0,25400
"Wicker, Roger",(R),American Hotel & Lodging Assn,25000,25000,0
"Wicker, Roger",(R),Home Depot,25000,25000,0
"Wicker, Roger",(R),Marathon Petroleum,25000,25000,0
"Wicker, Roger",(R),Norfolk Southern,25000,25000,0
"Wicker, Roger",(R),US Marine Inc,25000,0,25000
"Wicker, Roger",(R),DaVita Inc,24000,23500,500
"Wicker, Roger",(R),Capitol Resources,23950,0,23950
"Wicker, Roger",(R),Dunlap & Kyle,23600,0,23600
"Wicker, Roger",(R),Seafarers International Union,23500,23500,0
"Wicker, Roger",(R),"Akin, Gump et al",23000,8750,14250
"Wicker, Roger",(R),Golding Barge Line,22900,0,22900
"Wicker, Roger",(R),Southern Co,22655,22500,155
"Wicker, Roger",(R),Delta Air Lines,22550,22500,50
"Wicker, Roger",(R),General Motors,22500,22500,0
"Wicker, Roger",(R),International Paper,22500,22500,0
"Wicker, Roger",(R),Massachusetts Mutual Life Insurance,22500,22500,0
"Wicker, Roger",(R),National Beer Wholesalers Assn,22500,22500,0
"Wicker, Roger",(R),Quicken Loans,22300,6000,16300
"Wicker, Roger",(R),Seemann Composites,22100,0,22100
"Wicker, Roger",(R),American Airlines,22018,15000,7018
"Wicker, Roger",(R),iHeartMedia Inc,22000,22000,0
"Wicker, Roger",(R),Rumsfeld Foundation,21600,0,21600
"Wicker, Roger",(R),Harvey Gulf International Marine,21400,0,21400
"Wicker, Roger",(R),Independent Community Bankers of America,21000,21000,0
"Wicker, Roger",(R),Koch Industries,21000,20000,1000
"Wicker, Roger",(R),Woodbranch Investments,20600,0,20600
"Wicker, Roger",(R),Carnival Corp,20300,0,20300
"Wicker, Roger",(R),Amazon.com,20002,20000,2
"Wicker, Roger",(R),AFLAC Inc,20000,20000,0
"Wicker, Roger",(R),American Health Care Assn,20000,20000,0
"Wicker, Roger",(R),Automotive Free International Trade PAC,20000,20000,0
"Wicker, Roger",(R),Center for Sportfishing Policy,20000,17500,2500
"Wicker, Roger",(R),Walmart Inc,19563,19500,63
"Wicker, Roger",(R),Cornerstone Government Affairs,19200,0,19200
"Wicker, Roger",(R),National Rural Water Assn,18500,18500,0
"Wicker, Roger",(R),Toyota Motor North America,18000,18000,0
"Wicker, Roger",(R),WPP plc,17700,4000,13700
"Wicker, Roger",(R),American Bankers Assn,17525,17500,25
"Wicker, Roger",(R),Lockheed Martin,17525,17500,25
"Wicker, Roger",(R),American Waterways Operators,17500,17500,0
"Wicker, Roger",(R),Kirby Corp,17500,17500,0
"Wicker, Roger",(R),Mortgage Bankers Assn,17500,17500,0
"Wicker, Roger",(R),NTCA/Rural Broadband Assn,17500,17500,0
"Wicker, Roger",(R),Wine & Spirits Wholesalers of America,17500,17500,0
"Wicker, Roger",(R),Capitol Counsel,17166,0,17166
"Wicker, Roger",(R),Lumen Technologies,17005,17000,5
"Wicker, Roger",(R),Crowley Maritime,17000,17000,0
"Wicker, Roger",(R),National Assn of Home Builders,17000,17000,0
"Wicker, Roger",(R),Sinclair Broadcast Group,17000,2000,15000
"Wicker, Roger",(R),Watco Companies,16880,0,16880
"Wicker, Roger",(R),Edward C Levy Co,16800,0,16800
"Wicker, Roger",(R),CTIA,16750,15000,1750
"Wicker, Roger",(R),Morgan Stanley,16600,0,16600
"Wicker, Roger",(R),New York Life Insurance,16500,16500,0
"Wicker, Roger",(R),Blessey Marine Service,16200,10000,6200
"Wicker, Roger",(R),Yates Construction,16200,0,16200
"Wyden, Ron",(D),Blue Cross/Blue Shield,103993,65000,38993
"Wyden, Ron",(D),Nike Inc,94047,35000,59047
"Wyden, Ron",(D),Intel Corp,92419,29500,62919
"Wyden, Ron",(D),DaVita Inc,77153,43500,33653
"Wyden, Ron",(D),Alphabet Inc,70839,22500,48339
"Wyden, Ron",(D),League of Conservation Voters,66461,4500,61961
"Wyden, Ron",(D),Berkshire Hathaway,61051,16000,45051
"Wyden, Ron",(D),Metlife Inc,52522,16000,36522
"Wyden, Ron",(D),Kindred Healthcare,50600,30500,20100
"Wyden, Ron",(D),Capital Group Companies,50100,15000,35100
"Wyden, Ron",(D),Capitol Counsel,43200,0,43200
"Wyden, Ron",(D),Marquis Companies,41307,0,41307
"Wyden, Ron",(D),National Assn of Home Builders,40025,40000,25
"Wyden, Ron",(D),National Assn of Real Estate Investment Trusts,40000,40000,0
"Wyden, Ron",(D),National Multifamily Housing Council,40000,40000,0
"Wyden, Ron",(D),Associated Medical Professionals,39200,0,39200
"Wyden, Ron",(D),FedEx Corp,39135,39000,135
"Wyden, Ron",(D),"Welsh, Carson et al",38600,0,38600
"Wyden, Ron",(D),National Assn of Realtors,38480,36980,1500
"Wyden, Ron",(D),Amgen Inc,38425,30000,8425
"Wyden, Ron",(D),Greenbrier Companies,37700,0,37700
"Wyden, Ron",(D),National Beer Wholesalers Assn,37500,37500,0
"Wyden, Ron",(D),Huntsman Corp,36600,5000,31600
"Wyden, Ron",(D),Cow Creek Band of Umpqua Indians,35000,0,35000
"Wyden, Ron",(D),National Thoroughbred Racing Assn,35000,35000,0
"Wyden, Ron",(D),Wells Fargo,34303,8500,25803
"Wyden, Ron",(D),Vibra Healthcare,34300,0,34300
"Wyden, Ron",(D),AFLAC Inc,33500,33500,0
"Wyden, Ron",(D),American Health Care Assn,33500,22500,11000
"Wyden, Ron",(D),Verizon Communications,33130,33000,130
"Wyden, Ron",(D),Prudential Financial,32500,7500,25000
"Wyden, Ron",(D),Microsoft Corp,32452,24000,8452
"Wyden, Ron",(D),Cigna Corp,31889,20000,11889
"Wyden, Ron",(D),Oregon Health & Science University,31812,0,31812
"Wyden, Ron",(D),Columbia Sportswear,31775,0,31775
"Wyden, Ron",(D),BlackRock Inc,31750,6000,25750
"Wyden, Ron",(D),Citigroup Inc,31734,5000,26734
"Wyden, Ron",(D),eBay Inc,31393,9500,21893
"Wyden, Ron",(D),Centene Corp,31366,17500,13866
"Wyden, Ron",(D),Brookfield Asset Management,30800,19300,11500
"Wyden, Ron",(D),Honeywell International,30541,30500,41
"Wyden, Ron",(D),General Motors,30010,30000,10
"Wyden, Ron",(D),American Medical Assn,30000,30000,0
"Wyden, Ron",(D),Emerson Electric,30000,30000,0
"Wyden, Ron",(D),Federation of American Hospitals,30000,30000,0
"Wyden, Ron",(D),National Rural Electric Cooperative Assn,30000,30000,0
"Wyden, Ron",(D),DISH Network,29900,10000,19900
"Wyden, Ron",(D),M Financial Group,29900,0,29900
"Wyden, Ron",(D),DLA Piper,29738,5000,24738
"Wyden, Ron",(D),Deloitte LLP,28781,27500,1281
"Wyden, Ron",(D),Providence Health & Services,28336,0,28336
"Wyden, Ron",(D),CVS Health,28025,28000,25
"Wyden, Ron",(D),Amedisys Inc,27500,25000,2500
"Wyden, Ron",(D),California Dairies Inc,27500,27500,0
"Wyden, Ron",(D),Pfizer Inc,27036,27000,36
"Wyden, Ron",(D),American Soc/Pension Prof & Actuaries,27000,26000,1000
"Wyden, Ron",(D),Pacific Life Insurance,26800,20500,6300
"Wyden, Ron",(D),State of Oregon,26778,0,26778
"Wyden, Ron",(D),Eli Lilly & Co,26700,19000,7700
"Wyden, Ron",(D),Global Partners LP,26600,0,26600
"Wyden, Ron",(D),Winged Keel Group,26500,0,26500
"Wyden, Ron",(D),Children's Research & Education Institute,26200,0,26200
"Wyden, Ron",(D),Provenance Hotels,26000,0,26000
"Wyden, Ron",(D),Pacific Star Corp,25600,0,25600
"Wyden, Ron",(D),Peter G Peterson Foundation,25600,0,25600
"Wyden, Ron",(D),International Brotherhood of Electrical Workers,25552,25000,552
"Wyden, Ron",(D),Hewlett Packard Enterprise,25015,25000,15
"Wyden, Ron",(D),Chubb INA,25000,8500,16500
"Wyden, Ron",(D),Direct Supply Inc,25000,22500,2500
"Wyden, Ron",(D),Select Medical Corp,25000,20000,5000
"Wyden, Ron",(D),Northwestern Mutual,24824,17500,7324
"Wyden, Ron",(D),Fresenius Medical Care,24697,10000,14697
"Wyden, Ron",(D),United Parcel Service,24578,24542,36
"Wyden, Ron",(D),McKesson Corp,24550,22500,2050
"Wyden, Ron",(D),"Akin, Gump et al",24460,1400,23060
"Wyden, Ron",(D),American Institute of CPAs,24000,24000,0
"Wyden, Ron",(D),"Kleiner, Perkins et al",23500,0,23500
"Wyden, Ron",(D),Mortgage Bankers Assn,23500,23500,0
"Wyden, Ron",(D),National Assn of Broadcasters,23500,18500,5000
"Wyden, Ron",(D),Xcel Energy,23500,23500,0
"Wyden, Ron",(D),Richman Group,22800,0,22800
"Wyden, Ron",(D),AbbVie Inc,22511,22500,11
"Wyden, Ron",(D),Sempra Energy,22500,22500,0
"Wyden, Ron",(D),Wilmerhale Llp,22114,0,22114
"Wyden, Ron",(D),Apollo Global Management,22110,12000,10110
"Wyden, Ron",(D),American Assn for Justice,22000,22000,0
"Wyden, Ron",(D),Amir Development,22000,0,22000
"Wyden, Ron",(D),National Assn of Health Underwriters,22000,16500,5500
"Wyden, Ron",(D),New York Life Insurance,22000,5000,17000
"Wyden, Ron",(D),Toyota Motor Corp,21952,21500,452
"Wyden, Ron",(D),Peter J Brix Investments,21400,0,21400
"Wyden, Ron",(D),AT&T Inc,21300,10000,11300
"Wyden, Ron",(D),"Paul, Weiss et al",21155,0,21155
"Wyden, Ron",(D),Warland Investments,21000,0,21000
"Wyden, Ron",(D),Steward Health Care,20900,4000,16900
"Wyden, Ron",(D),Prestige Care,20700,0,20700
"Wyden, Ron",(D),Veritas Capital,20600,12000,8600
"Wyden, Ron",(D),Abbott Laboratories,20500,20500,0
"Wyden, Ron",(D),Merck & Co,20500,18000,2500
"Wyden, Ron",(D),Massachusetts Mutual Life Insurance,20400,20000,400
"Young, Todd",(R),Votesane PAC,290025,0,290025
"Young, Todd",(R),DaVita Inc,159900,26000,133900
"Young, Todd",(R),Eli Lilly & Co,106675,29500,77175
"Young, Todd",(R),Amway/Alticor Inc,96500,2000,94500
"Young, Todd",(R),Barnes & Thornburg,84200,3500,80700
"Young, Todd",(R),Berkshire Hathaway,82890,35000,47890
"Young, Todd",(R),Heritage Group,73000,0,73000
"Young, Todd",(R),Capital Group Companies,64050,15000,49050
"Young, Todd",(R),National Assn of Broadcasters,61280,16000,45280
"Young, Todd",(R),LHC Group,60700,12500,48200
"Young, Todd",(R),CVS Health,60575,34000,26575
"Young, Todd",(R),Deloitte LLP,55710,30000,25710
"Young, Todd",(R),Padgett Inc,54500,0,54500
"Young, Todd",(R),Kjb Inc,53200,0,53200
"Young, Todd",(R),Masimo Corp,52000,10000,42000
"Young, Todd",(R),Blackstone Group,51000,0,51000
"Young, Todd",(R),Proskauer Rose,50500,0,50500
"Young, Todd",(R),"Faegre, Drinker et al",50150,9000,41150
"Young, Todd",(R),UnitedHealth Group,49660,37500,12160
"Young, Todd",(R),Pacers Sports & Entertainment,49650,0,49650
"Young, Todd",(R),Irwin R Rose & Co,49400,0,49400
"Young, Todd",(R),Devon Energy,48200,5000,43200
"Young, Todd",(R),National Republican Senatorial Cmte,46801,46800,1
"Young, Todd",(R),Anthem Inc,46245,20000,26245
"Young, Todd",(R),Energy Capital Partners,45500,0,45500
"Young, Todd",(R),Ice Miller LLP,45350,7000,38350
"Young, Todd",(R),Purdue University,43675,0,43675
"Young, Todd",(R),Asphalt Materials Inc,43500,0,43500
"Young, Todd",(R),M International,43300,0,43300
"Young, Todd",(R),Schahet Hotels,39400,0,39400
"Young, Todd",(R),Alliance Resource Partners,39100,5000,34100
"Young, Todd",(R),Nucor Corp,39100,5000,34100
"Young, Todd",(R),Taxspeaker,38500,0,38500
"Young, Todd",(R),Simon Property Group,37900,0,37900
"Young, Todd",(R),Blue Cross/Blue Shield,37825,25000,12825
"Young, Todd",(R),Morgan Stanley,37790,5500,32290
"Young, Todd",(R),Elwood Staffing Services,37700,0,37700
"Young, Todd",(R),Geo Pfau's Sons,37600,0,37600
"Young, Todd",(R),Polaris Industries,37400,2500,34900
"Young, Todd",(R),State of Indiana,37100,0,37100
"Young, Todd",(R),"Mehlman, Castagnetti et al",37050,0,37050
"Young, Todd",(R),AT&T Inc,37031,30000,7031
"Young, Todd",(R),Prescott Investors,37000,0,37000
"Young, Todd",(R),Goldman Sachs,36700,10000,26700
"Young, Todd",(R),WPP plc,36700,2000,34700
"Young, Todd",(R),Marathon Petroleum,36025,36000,25
"Young, Todd",(R),Massachusetts Mutual Life Insurance,35525,25000,10525
"Young, Todd",(R),ANGI Homeservices,35400,0,35400
"Young, Todd",(R),American Senior Communities,35200,0,35200
"Young, Todd",(R),Hohlt Group,34900,0,34900
"Young, Todd",(R),Fierce Government Relations,34300,0,34300
"Young, Todd",(R),Kocolene Development,34150,0,34150
"Young, Todd",(R),Wabash Valley Produce,34100,0,34100
"Young, Todd",(R),Health Carousel,34000,0,34000
"Young, Todd",(R),Cardon & Assoc,33800,0,33800
"Young, Todd",(R),Heritage Food Service Equipment,33700,0,33700
"Young, Todd",(R),Jennmar Corp,33500,0,33500
"Young, Todd",(R),CenterPoint Energy,33210,7500,25710
"Young, Todd",(R),Rogers Group,33050,0,33050
"Young, Todd",(R),Abro Industries,33000,0,33000
"Young, Todd",(R),Koch Enterprises,32800,0,32800
"Young, Todd",(R),Grammer Industries,32700,0,32700
"Young, Todd",(R),Hanning & Bean Enterprises,32600,0,32600
"Young, Todd",(R),Apogee Physicians,32400,0,32400
"Young, Todd",(R),Banner Engineering,32400,0,32400
"Young, Todd",(R),Jordan Manufacturing,32400,0,32400
"Young, Todd",(R),Humana Inc,32275,28000,4275
"Young, Todd",(R),Gant Travel Management,32200,0,32200
"Young, Todd",(R),United Parcel Service,31929,29499,2430
"Young, Todd",(R),National Assn of Real Estate Investment Trusts,31000,30000,1000
"Young, Todd",(R),Cigna Corp,30551,30000,551
"Young, Todd",(R),Amgen Inc,30550,8000,22550
"Young, Todd",(R),YUM! Brands,30443,3000,27443
"Young, Todd",(R),Berry Plastics,30200,0,30200
"Young, Todd",(R),Honeywell International,30125,30000,125
"Young, Todd",(R),Cook Group,29800,0,29800
"Young, Todd",(R),Comcast Corp,29750,25000,4750
"Young, Todd",(R),Bank of Se Europe,29600,0,29600
"Young, Todd",(R),Kent Companies,29600,0,29600
"Young, Todd",(R),Spencer Enterprises,29500,0,29500
"Young, Todd",(R),Northrop Grumman,29060,27500,1560
"Young, Todd",(R),Ollier Masonry,28950,0,28950
"Young, Todd",(R),Abbott Laboratories,28700,28500,200
"Young, Todd",(R),Maple Leaf Farms,28700,0,28700
"Young, Todd",(R),Asplundh Tree Expert Co,28600,5000,23600
"Young, Todd",(R),Central Indiana Corporate Partnership,28400,0,28400
"Young, Todd",(R),Pfizer Inc,28350,26000,2350
"Young, Todd",(R),RTW Investments,27900,0,27900
"Young, Todd",(R),UBS AG,27700,25000,2700
"Young, Todd",(R),American Hotel & Lodging Assn,27500,27500,0
"Young, Todd",(R),Royer Corp,27400,0,27400
"Young, Todd",(R),FedEx Corp,27055,27000,55
"Young, Todd",(R),Peoplelink LLC,27000,0,27000
"Young, Todd",(R),White Lodging Services,27000,0,27000
"Young, Todd",(R),Alphabet Inc,26870,22000,4870
"Young, Todd",(R),Hilton Worldwide,26825,2500,24325
"Young, Todd",(R),Mulzer Crushed Stone,26750,0,26750
"Young, Todd",(R),Pilot Corp,26700,0,26700
"Young, Todd",(R),North American Midway Entertainment,26600,0,26600
"Young, Todd",(R),Crowe LLP,26325,7000,19325
